Year,Period,labor force participation rate,employment-population ratio,labor force,employment,unemployment,unemployment rate
1976,Jan,60,53.8,972413,872738,99675,10.3
1976,Feb,59.8,53.6,971753,871997,99756,10.3
1976,Mar,59.6,53.5,971967,872637,99330,10.2
1976,Apr,59.6,53.6,974938,877217,97721,10
1976,May,59.6,53.8,979281,883408,95873,9.8
1976,Jun,59.8,54,984254,890022,94232,9.6
1976,Jul,59.9,54.2,988887,895746,93141,9.4
1976,Aug,59.9,54.3,993223,900283,92940,9.4
1976,Sep,59.9,54.3,997610,904382,93228,9.3
1976,Oct,60,54.4,1001958,908289,93669,9.3
1976,Nov,60,54.4,1006303,912353,93950,9.3
1976,Dec,60,54.5,1010700,916965,93735,9.3
1977,Jan,60.1,54.6,1015516,922428,93088,9.2
1977,Feb,60.2,54.7,1020831,928840,91991,9
1977,Mar,60.3,54.9,1026273,935794,90479,8.8
1977,Apr,60.3,55.1,1031901,942915,88986,8.6
1977,May,60.5,55.4,1037677,949864,87813,8.5
1977,Jun,60.5,55.5,1043243,956280,86963,8.3
1977,Jul,60.6,55.6,1048322,962096,86226,8.2
1977,Aug,60.6,55.7,1052303,967390,84913,8.1
1977,Sep,60.5,55.8,1055055,972195,82860,7.9
1977,Oct,60.4,55.8,1056648,976316,80332,7.6
1977,Nov,60.2,55.8,1057172,979701,77471,7.3
1977,Dec,60,55.7,1057127,982527,74600,7.1
1978,Jan,59.7,55.7,1057365,985501,71864,6.8
1978,Feb,59.6,55.7,1058731,989151,69580,6.6
1978,Mar,59.5,55.7,1061661,993785,67876,6.4
1978,Apr,59.5,55.8,1065846,999458,66388,6.2
1978,May,59.6,56,1070968,1005984,64984,6.1
1978,Jun,59.7,56.2,1076814,1013060,63754,5.9
1978,Jul,59.8,56.4,1082843,1019978,62865,5.8
1978,Aug,59.9,56.4,1089073,1026450,62623,5.8
1978,Sep,60,56.5,1095979,1033103,62876,5.7
1978,Oct,60.1,56.7,1104172,1040900,63272,5.7
1978,Nov,60.4,56.9,1113812,1050048,63764,5.7
1978,Dec,60.6,57.2,1123492,1059541,63951,5.7
1979,Jan,60.8,57.4,1131494,1067974,63520,5.6
1979,Feb,60.8,57.4,1136935,1074575,62360,5.5
1979,Mar,60.7,57.4,1139708,1079124,60584,5.3
1979,Apr,60.4,57.3,1140474,1081848,58626,5.1
1979,May,60.1,57.1,1140642,1083835,56807,5
1979,Jun,59.9,57,1141618,1086193,55425,4.9
1979,Jul,59.8,57,1144815,1090164,54651,4.8
1979,Aug,59.9,57.1,1150919,1096266,54653,4.7
1979,Sep,60.1,57.2,1159434,1103839,55595,4.8
1979,Oct,60.4,57.4,1169321,1111832,57489,4.9
1979,Nov,60.7,57.6,1179665,1119450,60215,5.1
1979,Dec,61,57.7,1190048,1126195,63853,5.4
1980,Jan,61.2,57.8,1199875,1131550,68325,5.7
1980,Feb,61.5,57.7,1208477,1135235,73242,6.1
1980,Mar,61.6,57.6,1215704,1137477,78227,6.4
1980,Apr,61.7,57.5,1221587,1138920,82667,6.8
1980,May,61.7,57.4,1226105,1140128,85977,7
1980,Jun,61.8,57.3,1229764,1141836,87928,7.1
1980,Jul,61.8,57.3,1232887,1144482,88405,7.2
1980,Aug,61.8,57.4,1235500,1148049,87451,7.1
1980,Sep,61.7,57.5,1237586,1152188,85398,6.9
1980,Oct,61.6,57.5,1239163,1156406,82757,6.7
1980,Nov,61.6,57.6,1240750,1160692,80058,6.5
1980,Dec,61.6,57.7,1243446,1165674,77772,6.3
1981,Jan,61.6,57.9,1247648,1171601,76047,6.1
1981,Feb,61.7,58,1252938,1178115,74823,6
1981,Mar,61.9,58.2,1258809,1184832,73977,5.9
1981,Apr,62,58.4,1264477,1190951,73526,5.8
1981,May,62.1,58.5,1269131,1195613,73518,5.8
1981,Jun,62.1,58.5,1272475,1198557,73918,5.8
1981,Jul,62.1,58.4,1274735,1199700,75035,5.9
1981,Aug,62,58.2,1276661,1199382,77279,6.1
1981,Sep,61.9,58,1279101,1198501,80600,6.3
1981,Oct,61.9,57.8,1282772,1197844,84928,6.6
1981,Nov,62,57.7,1287452,1197343,90109,7
1981,Dec,62.1,57.5,1292880,1197008,95872,7.4
1982,Jan,62.3,57.4,1299433,1197337,102096,7.9
1982,Feb,62.5,57.3,1307327,1198547,108780,8.3
1982,Mar,62.7,57.2,1316056,1200373,115683,8.8
1982,Apr,63,57.2,1325441,1202775,122666,9.3
1982,May,63.3,57.2,1335090,1205500,129590,9.7
1982,Jun,63.5,57.1,1344035,1207864,136171,10.1
1982,Jul,63.8,57,1351611,1209419,142192,10.5
1982,Aug,63.9,56.9,1357541,1210096,147445,10.9
1982,Sep,63.9,56.8,1361931,1209996,151935,11.2
1982,Oct,63.8,56.6,1364954,1209541,155413,11.4
1982,Nov,63.8,56.4,1366976,1209718,157258,11.5
1982,Dec,63.6,56.3,1368048,1210987,157061,11.5
1983,Jan,63.5,56.3,1368306,1213496,154810,11.3
1983,Feb,63.3,56.3,1368580,1217823,150757,11
1983,Mar,63.2,56.4,1369809,1224360,145449,10.6
1983,Apr,63.1,56.7,1372593,1233163,139430,10.2
1983,May,63.1,57,1376961,1243872,133089,9.7
1983,Jun,63.2,57.4,1382566,1255822,126744,9.2
1983,Jul,63.3,57.8,1388626,1268448,120178,8.7
1983,Aug,63.4,58.2,1394073,1280973,113100,8.1
1983,Sep,63.4,58.6,1398261,1292727,105534,7.5
1983,Oct,63.3,58.9,1401248,1303358,97890,7
1983,Nov,63.3,59.2,1403535,1312542,90993,6.5
1983,Dec,63.2,59.3,1405824,1320468,85356,6.1
1984,Jan,63.1,59.5,1408788,1327887,80901,5.7
1984,Feb,63.1,59.6,1412596,1335279,77317,5.5
1984,Mar,63.1,59.8,1416927,1342498,74429,5.3
1984,Apr,63.1,59.9,1421156,1349121,72035,5.1
1984,May,63.1,60,1425187,1355046,70141,4.9
1984,Jun,63.1,60.1,1428973,1360150,68823,4.8
1984,Jul,63.1,60.1,1432586,1364186,68400,4.8
1984,Aug,63.1,60,1436576,1367166,69410,4.8
1984,Sep,63,59.9,1441199,1369373,71826,5
1984,Oct,63.1,59.8,1446550,1371478,75072,5.2
1984,Nov,63.2,59.8,1452761,1374268,78493,5.4
1984,Dec,63.3,59.7,1459471,1377782,81689,5.6
1985,Jan,63.3,59.7,1465634,1381054,84580,5.8
1985,Feb,63.3,59.6,1470262,1382982,87280,5.9
1985,Mar,63.2,59.4,1473001,1383229,89772,6.1
1985,Apr,63.1,59.2,1474550,1382503,92047,6.2
1985,May,63,59,1476114,1381862,94252,6.4
1985,Jun,62.9,58.8,1478808,1382557,96251,6.5
1985,Jul,62.9,58.8,1483303,1385439,97864,6.6
1985,Aug,63,58.8,1489554,1391033,98521,6.6
1985,Sep,63.2,59,1497013,1398861,98152,6.6
1985,Oct,63.4,59.3,1504897,1407510,97387,6.5
1985,Nov,63.5,59.5,1512378,1415587,96791,6.4
1985,Dec,63.6,59.6,1518986,1422252,96734,6.4
1986,Jan,63.7,59.7,1525219,1427668,97551,6.4
1986,Feb,63.9,59.7,1532054,1432753,99301,6.5
1986,Mar,64,59.8,1540035,1438266,101769,6.6
1986,Apr,64.3,59.9,1548830,1444229,104601,6.8
1986,May,64.5,60,1557429,1450171,107258,6.9
1986,Jun,64.6,60.1,1565280,1455778,109502,7
1986,Jul,64.7,60.2,1571912,1460653,111259,7.1
1986,Aug,64.7,60.1,1576976,1464410,112566,7.1
1986,Sep,64.7,60.1,1580687,1467127,113560,7.2
1986,Oct,64.6,60,1583506,1469452,114054,7.2
1986,Nov,64.5,59.9,1585859,1471883,113976,7.2
1986,Dec,64.4,59.8,1588732,1475400,113332,7.1
1987,Jan,64.4,59.9,1592550,1480457,112093,7
1987,Feb,64.4,59.9,1596953,1486641,110312,6.9
1987,Mar,64.4,60,1601894,1493626,108268,6.8
1987,Apr,64.4,60.1,1607041,1500877,106164,6.6
1987,May,64.4,60.2,1612060,1507857,104203,6.5
1987,Jun,64.4,60.3,1616703,1514089,102614,6.3
1987,Jul,64.4,60.4,1621164,1519613,101551,6.3
1987,Aug,64.4,60.4,1625655,1524591,101064,6.2
1987,Sep,64.5,60.5,1630182,1529206,100976,6.2
1987,Oct,64.6,60.6,1634424,1533246,101178,6.2
1987,Nov,64.6,60.6,1638283,1536677,101606,6.2
1987,Dec,64.6,60.5,1641486,1539153,102333,6.2
1988,Jan,64.5,60.5,1643937,1540561,103376,6.3
1988,Feb,64.5,60.4,1646116,1541497,104619,6.4
1988,Mar,64.5,60.3,1648211,1542409,105802,6.4
1988,Apr,64.5,60.3,1650654,1543974,106680,6.5
1988,May,64.5,60.3,1654021,1546882,107139,6.5
1988,Jun,64.5,60.3,1658497,1551235,107262,6.5
1988,Jul,64.6,60.4,1664176,1556895,107281,6.4
1988,Aug,64.8,60.6,1671095,1563678,107417,6.4
1988,Sep,65,60.8,1678977,1571515,107462,6.4
1988,Oct,65.2,61.1,1687096,1580209,106887,6.3
1988,Nov,65.4,61.3,1694620,1589185,105435,6.2
1988,Dec,65.6,61.6,1700717,1597683,103034,6.1
1989,Jan,65.6,61.8,1705106,1605182,99924,5.9
1989,Feb,65.6,61.9,1707866,1611023,96843,5.7
1989,Mar,65.6,62,1709895,1615431,94464,5.5
1989,Apr,65.6,62,1711947,1618792,93155,5.4
1989,May,65.6,62.1,1714131,1621443,92688,5.4
1989,Jun,65.6,62.1,1716515,1624082,92433,5.4
1989,Jul,65.6,62.1,1718665,1626975,91690,5.3
1989,Aug,65.6,62.1,1720625,1630335,90290,5.2
1989,Sep,65.6,62.2,1723378,1634548,88830,5.2
1989,Oct,65.7,62.3,1728286,1640261,88025,5.1
1989,Nov,65.9,62.5,1735793,1647543,88250,5.1
1989,Dec,66.2,62.8,1745692,1656055,89637,5.1
1990,Jan,63.7,60.3,1757053,1665261,91792,5.2
1990,Feb,64,60.6,1768282,1674430,93852,5.3
1990,Mar,64.3,60.9,1777760,1682513,95247,5.4
1990,Apr,64.6,61.1,1784680,1688857,95823,5.4
1990,May,64.6,61.1,1789306,1693644,95662,5.3
1990,Jun,64.7,61.2,1791941,1696874,95067,5.3
1990,Jul,64.7,61.3,1793458,1698941,94517,5.3
1990,Aug,64.6,61.2,1794313,1700177,94136,5.2
1990,Sep,64.4,61,1793938,1700269,93669,5.2
1990,Oct,64.2,60.8,1792135,1699020,93115,5.2
1990,Nov,63.9,60.6,1789621,1697269,92352,5.2
1990,Dec,63.7,60.4,1787156,1695732,91424,5.1
1991,Jan,63.4,60.2,1785450,1694497,90953,5.1
1991,Feb,63.3,60.1,1785383,1694035,91348,5.1
1991,Mar,63.2,59.9,1786810,1694191,92619,5.2
1991,Apr,63.1,59.8,1789356,1694600,94756,5.3
1991,May,63.1,59.7,1793017,1695085,97932,5.5
1991,Jun,63.1,59.5,1797945,1695877,102068,5.7
1991,Jul,63.2,59.4,1803825,1697021,106804,5.9
1991,Aug,63.2,59.3,1810356,1698431,111925,6.2
1991,Sep,63.3,59.2,1817549,1700131,117418,6.5
1991,Oct,63.3,59,1824992,1701785,123207,6.8
1991,Nov,63.4,58.9,1832314,1703230,129084,7
1991,Dec,63.4,58.8,1839227,1704649,134578,7.3
1992,Jan,63.5,58.7,1845636,1706570,139066,7.5
1992,Feb,63.5,58.7,1851661,1709307,142354,7.7
1992,Mar,63.6,58.6,1857883,1713519,144364,7.8
1992,Apr,63.6,58.7,1864526,1719398,145128,7.8
1992,May,63.6,58.7,1870787,1726031,144756,7.7
1992,Jun,63.6,58.7,1875811,1732235,143576,7.7
1992,Jul,63.6,58.8,1879588,1737416,142172,7.6
1992,Aug,63.4,58.7,1882327,1741508,140819,7.5
1992,Sep,63.3,58.6,1884354,1744766,139588,7.4
1992,Oct,63.2,58.5,1886366,1748044,138322,7.3
1992,Nov,63,58.5,1888571,1751568,137003,7.3
1992,Dec,62.9,58.4,1891441,1755846,135595,7.2
1993,Jan,62.9,58.4,1895718,1761811,133907,7.1
1993,Feb,62.9,58.5,1901612,1769744,131868,6.9
1993,Mar,63,58.7,1909174,1779609,129565,6.8
1993,Apr,63,58.9,1918200,1791142,127058,6.6
1993,May,63.2,59.1,1928250,1803664,124586,6.5
1993,Jun,63.4,59.3,1939127,1816592,122535,6.3
1993,Jul,63.5,59.6,1950430,1829401,121029,6.2
1993,Aug,63.6,59.7,1962111,1841901,120210,6.1
1993,Sep,63.8,59.9,1974708,1854529,120179,6.1
1993,Oct,63.9,60,1988469,1867564,120905,6.1
1993,Nov,64.2,60.2,2003309,1881064,122245,6.1
1993,Dec,64.4,60.4,2018834,1895036,123798,6.1
1994,Jan,64.6,60.7,2034248,1908943,125305,6.2
1994,Feb,64.8,60.8,2048581,1921951,126630,6.2
1994,Mar,65,61,2061374,1933465,127909,6.2
1994,Apr,65.1,61,2072933,1943611,129322,6.2
1994,May,65.2,61.1,2084187,1953341,130846,6.3
1994,Jun,65.3,61.2,2095934,1963668,132266,6.3
1994,Jul,65.4,61.3,2108495,1975290,133205,6.3
1994,Aug,65.6,61.5,2121816,1988510,133306,6.3
1994,Sep,65.8,61.7,2135426,2003240,132186,6.2
1994,Oct,66,62,2148679,2018930,129749,6
1994,Nov,66.2,62.3,2161555,2035017,126538,5.9
1994,Dec,66.3,62.5,2173783,2050404,123379,5.7
1995,Jan,66.4,62.7,2185082,2064110,120972,5.5
1995,Feb,66.6,62.9,2195922,2076346,119576,5.4
1995,Mar,66.7,63.1,2206541,2087415,119126,5.4
1995,Apr,66.7,63.1,2216498,2097218,119280,5.4
1995,May,66.8,63.2,2225584,2105982,119602,5.4
1995,Jun,66.8,63.2,2233479,2113832,119647,5.4
1995,Jul,66.8,63.2,2239869,2120606,119263,5.3
1995,Aug,66.7,63.2,2244541,2125845,118696,5.3
1995,Sep,66.6,63.1,2247714,2129366,118348,5.3
1995,Oct,66.5,63,2250174,2131655,118519,5.3
1995,Nov,66.4,62.9,2252294,2133203,119091,5.3
1995,Dec,66.2,62.7,2254477,2134283,120194,5.3
1996,Jan,66.2,62.6,2257244,2135488,121756,5.4
1996,Feb,66.1,62.5,2260898,2137312,123586,5.5
1996,Mar,66.1,62.4,2265660,2140185,125475,5.5
1996,Apr,66,62.3,2271570,2144406,127164,5.6
1996,May,66.1,62.3,2278299,2149815,128484,5.6
1996,Jun,66.1,62.3,2285342,2155940,129402,5.7
1996,Jul,66.1,62.4,2292324,2162351,129973,5.7
1996,Aug,66.1,62.3,2298500,2168475,130025,5.7
1996,Sep,66,62.3,2302584,2173121,129463,5.6
1996,Oct,65.8,62.1,2303763,2175400,128363,5.6
1996,Nov,65.6,62,2302445,2175866,126579,5.5
1996,Dec,65.3,61.8,2299865,2176018,123847,5.4
1997,Jan,65,61.6,2297190,2176879,120311,5.2
1997,Feb,64.8,61.5,2295259,2178922,116337,5.1
1997,Mar,64.6,61.5,2294630,2182466,112164,4.9
1997,Apr,64.5,61.4,2295727,2187407,108320,4.7
1997,May,64.4,61.4,2298135,2192966,105169,4.6
1997,Jun,64.3,61.4,2301551,2198669,102882,4.5
1997,Jul,64.2,61.4,2305960,2204528,101432,4.4
1997,Aug,64.2,61.4,2311287,2210559,100728,4.4
1997,Sep,64.2,61.4,2317375,2216894,100481,4.3
1997,Oct,64.3,61.5,2323905,2223437,100468,4.3
1997,Nov,64.3,61.5,2330434,2229811,100623,4.3
1997,Dec,64.3,61.6,2336897,2236098,100799,4.3
1998,Jan,64.4,61.6,2343427,2242565,100862,4.3
1998,Feb,64.4,61.7,2350129,2249336,100793,4.3
1998,Mar,64.5,61.8,2356916,2256223,100693,4.3
1998,Apr,64.6,61.8,2364134,2263505,100629,4.3
1998,May,64.7,61.9,2372247,2271482,100765,4.2
1998,Jun,64.8,62,2381080,2279870,101210,4.3
1998,Jul,64.9,62.1,2390128,2288207,101921,4.3
1998,Aug,65,62.2,2399495,2296662,102833,4.3
1998,Sep,65.1,62.3,2409457,2305432,104025,4.3
1998,Oct,65.3,62.4,2419713,2314353,105360,4.4
1998,Nov,65.4,62.5,2429472,2322617,106855,4.4
1998,Dec,65.5,62.6,2438165,2329535,108630,4.5
1999,Jan,65.6,62.6,2445634,2335229,110405,4.5
1999,Feb,65.7,62.7,2452267,2340308,111959,4.6
1999,Mar,65.7,62.7,2458502,2345447,113055,4.6
1999,Apr,65.7,62.7,2464161,2350763,113398,4.6
1999,May,65.7,62.7,2468947,2356069,112878,4.6
1999,Jun,65.7,62.7,2473164,2361415,111749,4.5
1999,Jul,65.7,62.8,2476961,2366522,110439,4.5
1999,Aug,65.7,62.8,2480341,2371200,109141,4.4
1999,Sep,65.6,62.8,2483572,2375715,107857,4.3
1999,Oct,65.6,62.8,2487121,2380469,106652,4.3
1999,Nov,65.6,62.8,2491425,2386015,105410,4.2
1999,Dec,65.6,62.8,2495969,2391947,104022,4.2
2000,Jan,65.6,62.9,2499980,2397307,102673,4.1
2000,Feb,65.5,62.9,2502752,2401290,101462,4.1
2000,Mar,65.4,62.8,2503992,2403395,100597,4
2000,Apr,65.5,62.9,2503989,2403807,100182,4
2000,May,65.3,62.7,2503461,2403463,99998,4
2000,Jun,65.2,62.6,2502998,2403304,99694,4
2000,Jul,65,62.5,2503457,2404429,99028,4
2000,Aug,64.9,62.4,2505964,2407748,98216,3.9
2000,Sep,64.9,62.4,2510866,2413298,97568,3.9
2000,Oct,64.9,62.4,2518133,2420741,97392,3.9
2000,Nov,65,62.5,2527291,2429202,98089,3.9
2000,Dec,65.1,62.6,2537351,2437634,99717,3.9
2001,Jan,65.2,62.6,2546950,2444878,102072,4
2001,Feb,65.3,62.6,2555131,2450316,104815,4.1
2001,Mar,65.3,62.6,2561507,2453918,107589,4.2
2001,Apr,65.3,62.5,2566426,2455848,110578,4.3
2001,May,65.3,62.4,2571158,2457001,114157,4.4
2001,Jun,65.3,62.3,2576725,2458198,118527,4.6
2001,Jul,65.3,62.2,2583941,2460229,123712,4.8
2001,Aug,65.4,62.1,2592392,2462929,129463,5
2001,Sep,65.4,62,2601571,2466146,135425,5.2
2001,Oct,65.5,62,2611118,2469958,141160,5.4
2001,Nov,65.6,61.9,2620418,2474170,146248,5.6
2001,Dec,65.7,61.9,2629540,2478895,150645,5.7
2002,Jan,65.7,61.9,2638754,2484317,154437,5.9
2002,Feb,65.8,61.9,2647828,2490127,157701,6
2002,Mar,65.9,61.9,2656594,2496029,160565,6
2002,Apr,66,61.9,2665340,2502499,162841,6.1
2002,May,66,62,2673923,2509479,164444,6.1
2002,Jun,66.1,62,2682097,2516621,165476,6.2
2002,Jul,66.1,62,2689164,2523091,166073,6.2
2002,Aug,66.1,62,2694734,2528429,166305,6.2
2002,Sep,66,61.9,2698786,2532559,166227,6.2
2002,Oct,65.9,61.9,2701144,2535294,165850,6.1
2002,Nov,65.8,61.8,2702558,2537511,165047,6.1
2002,Dec,65.7,61.7,2703962,2540225,163737,6.1
2003,Jan,65.6,61.7,2706655,2544395,162260,6
2003,Feb,65.6,61.7,2711503,2550501,161002,5.9
2003,Mar,65.7,61.8,2718015,2557872,160143,5.9
2003,Apr,65.7,61.8,2724802,2565008,159794,5.9
2003,May,65.7,61.8,2730641,2570767,159874,5.9
2003,Jun,65.7,61.8,2735343,2575435,159908,5.8
2003,Jul,65.6,61.8,2739185,2579886,159299,5.8
2003,Aug,65.5,61.7,2742787,2584935,157852,5.8
2003,Sep,65.4,61.7,2746888,2591254,155634,5.7
2003,Oct,65.4,61.7,2752011,2599010,153001,5.6
2003,Nov,65.3,61.8,2758026,2607421,150605,5.5
2003,Dec,65.3,61.8,2764152,2615350,148802,5.4
2004,Jan,65.3,61.8,2769453,2621906,147547,5.3
2004,Feb,65.2,61.8,2773830,2627080,146750,5.3
2004,Mar,65.2,61.8,2778150,2631906,146244,5.3
2004,Apr,65.1,61.7,2782704,2637249,145455,5.2
2004,May,65.1,61.7,2787519,2643477,144042,5.2
2004,Jun,65,61.7,2792608,2650540,142068,5.1
2004,Jul,65,61.7,2797903,2658095,139808,5
2004,Aug,64.9,61.7,2803148,2665625,137523,4.9
2004,Sep,64.8,61.7,2808061,2672425,135636,4.8
2004,Oct,64.7,61.6,2812645,2678079,134566,4.8
2004,Nov,64.6,61.5,2817364,2683006,134358,4.8
2004,Dec,64.5,61.4,2823278,2688351,134927,4.8
2005,Jan,64.5,61.4,2830958,2695075,135883,4.8
2005,Feb,64.5,61.4,2840084,2703444,136640,4.8
2005,Mar,64.6,61.5,2850253,2713482,136771,4.8
2005,Apr,64.6,61.5,2861235,2724927,136308,4.8
2005,May,64.7,61.6,2872494,2737094,135400,4.7
2005,Jun,64.7,61.7,2883042,2748627,134415,4.7
2005,Jul,64.7,61.7,2892165,2758349,133816,4.6
2005,Aug,64.7,61.7,2899721,2766145,133576,4.6
2005,Sep,64.6,61.6,2906315,2772821,133494,4.6
2005,Oct,64.5,61.5,2913070,2779796,133274,4.6
2005,Nov,64.4,61.5,2920757,2787983,132774,4.5
2005,Dec,64.4,61.5,2929493,2797474,132019,4.5
2006,Jan,64.4,61.6,2939280,2808150,131130,4.5
2006,Feb,64.5,61.6,2949623,2819292,130331,4.4
2006,Mar,64.5,61.7,2959737,2829981,129756,4.4
2006,Apr,64.5,61.7,2969004,2839639,129365,4.4
2006,May,64.6,61.8,2977575,2848714,128861,4.3
2006,Jun,64.6,61.8,2985775,2857800,127975,4.3
2006,Jul,64.6,61.8,2994425,2867839,126586,4.2
2006,Aug,64.6,61.9,3003955,2878987,124968,4.2
2006,Sep,64.7,62,3013586,2890291,123295,4.1
2006,Oct,64.7,62.1,3022312,2900740,121572,4
2006,Nov,64.7,62.1,3029102,2909091,120011,4
2006,Dec,64.6,62.1,3032885,2914223,118662,3.9
2007,Jan,64.5,62,3033441,2915978,117463,3.9
2007,Feb,64.3,61.8,3031851,2915599,116252,3.8
2007,Mar,64.1,61.7,3029105,2914290,114815,3.8
2007,Apr,63.9,61.5,3026411,2913319,113092,3.7
2007,May,63.7,61.4,3024750,2913403,111347,3.7
2007,Jun,63.6,61.3,3024732,2914669,110063,3.6
2007,Jul,63.5,61.2,3026555,2916639,109916,3.6
2007,Aug,63.4,61.1,3030333,2918770,111563,3.7
2007,Sep,63.4,61,3036055,2921025,115030,3.8
2007,Oct,63.5,60.9,3042969,2922929,120040,3.9
2007,Nov,63.5,60.9,3050277,2924478,125799,4.1
2007,Dec,63.5,60.8,3057685,2925854,131831,4.3
2008,Jan,63.6,60.7,3064872,2926636,138236,4.5
2008,Feb,63.6,60.6,3071715,2926593,145122,4.7
2008,Mar,63.6,60.5,3078672,2925742,152930,5
2008,Apr,63.7,60.3,3086160,2924015,162145,5.3
2008,May,63.7,60.2,3094308,2921576,172732,5.6
2008,Jun,63.8,60,3103036,2918967,184069,5.9
2008,Jul,63.8,59.8,3111845,2916357,195488,6.3
2008,Aug,63.9,59.7,3119852,2913360,206492,6.6
2008,Sep,63.9,59.5,3126192,2909013,217179,6.9
2008,Oct,63.9,59.3,3130478,2902497,227981,7.3
2008,Nov,63.9,59,3132628,2893408,239220,7.6
2008,Dec,63.8,58.7,3133132,2882194,250938,8
2009,Jan,63.7,58.4,3132436,2869750,262686,8.4
2009,Feb,63.6,58.1,3131559,2857465,274094,8.8
2009,Mar,63.5,57.8,3131780,2847144,284636,9.1
2009,Apr,63.5,57.5,3133389,2839332,294057,9.4
2009,May,63.5,57.3,3135363,2832563,302800,9.7
2009,Jun,63.4,57.1,3136698,2825341,311357,9.9
2009,Jul,63.3,56.9,3136081,2816534,319547,10.2
2009,Aug,63.1,56.6,3132849,2805980,326869,10.4
2009,Sep,63,56.3,3128000,2795046,332954,10.6
2009,Oct,62.8,56,3122493,2785206,337287,10.8
2009,Nov,62.6,55.8,3117876,2778192,339684,10.9
2009,Dec,62.5,55.6,3115422,2775036,340386,10.9
2010,Jan,62.4,55.6,3114963,2775542,339421,10.9
2010,Feb,62.3,55.6,3114578,2777742,336836,10.8
2010,Mar,62.2,55.5,3112379,2779363,333016,10.7
2010,Apr,64.2,57.4,3107972,2779450,328522,10.6
2010,May,64,57.4,3101692,2778096,323596,10.4
2010,Jun,63.8,57.2,3094080,2775146,318934,10.3
2010,Jul,63.6,57.1,3086291,2770957,315334,10.2
2010,Aug,63.3,56.9,3079408,2766497,312911,10.2
2010,Sep,63.1,56.7,3073232,2762089,311143,10.1
2010,Oct,62.9,56.6,3067756,2758460,309296,10.1
2010,Nov,62.7,56.5,3062664,2755692,306972,10
2010,Dec,62.6,56.3,3057057,2753511,303546,9.9
2011,Jan,62.4,56.2,3051635,2751937,299698,9.8
2011,Feb,62.2,56.2,3047219,2750390,296829,9.7
2011,Mar,62.1,56,3043638,2748304,295334,9.7
2011,Apr,61.9,55.9,3040387,2745380,295007,9.7
2011,May,61.8,55.8,3037670,2742239,295431,9.7
2011,Jun,61.7,55.7,3035585,2740189,295396,9.7
2011,Jul,61.6,55.6,3034074,2740390,293684,9.7
2011,Aug,61.5,55.6,3032960,2742980,289980,9.6
2011,Sep,61.4,55.6,3032042,2747441,284601,9.4
2011,Oct,61.2,55.6,3031234,2752767,278467,9.2
2011,Nov,61.1,55.6,3030271,2757700,272571,9
2011,Dec,61,55.6,3029294,2761310,267984,8.8
2012,Jan,60.9,55.6,3028300,2763459,264841,8.7
2012,Feb,60.8,55.6,3027474,2764958,262516,8.7
2012,Mar,60.8,55.5,3027314,2766197,261117,8.6
2012,Apr,60.7,55.5,3027619,2767531,260088,8.6
2012,May,60.6,55.5,3028537,2769954,258583,8.5
2012,Jun,60.6,55.5,3029753,2773665,256088,8.5
2012,Jul,60.5,55.5,3030883,2778294,252589,8.3
2012,Aug,60.4,55.5,3031732,2783077,248655,8.2
2012,Sep,60.4,55.5,3032171,2787112,245059,8.1
2012,Oct,60.3,55.5,3031497,2789222,242275,8
2012,Nov,60.2,55.4,3029541,2788907,240634,7.9
2012,Dec,60,55.3,3026754,2786776,239978,7.9
2013,Jan,59.9,55.1,3023927,2783920,240007,7.9
2013,Feb,59.8,55,3021932,2781860,240072,7.9
2013,Mar,59.7,55,3021364,2781934,239430,7.9
2013,Apr,59.7,55,3023002,2784799,238203,7.9
2013,May,59.7,55,3025925,2788992,236933,7.8
2013,Jun,59.6,55,3028952,2792987,235965,7.8
2013,Jul,59.6,55,3031474,2796196,235278,7.8
2013,Aug,59.5,54.9,3032939,2798714,234225,7.7
2013,Sep,59.5,54.9,3033776,2801365,232411,7.7
2013,Oct,59.4,54.9,3035645,2805357,230288,7.6
2013,Nov,59.4,54.9,3039532,2811745,227787,7.5
2013,Dec,59.4,55,3045046,2820238,224808,7.4
2014,Jan,59.6,55.3,3061071,2839124,221947,7.3
2014,Feb,59.7,55.4,3067752,2849262,218490,7.1
2014,Mar,59.7,55.5,3074365,2858757,215608,7
2014,Apr,59.7,55.6,3080183,2866830,213353,6.9
2014,May,59.8,55.7,3085658,2874193,211465,6.9
2014,Jun,59.8,55.7,3092241,2882391,209850,6.8
2014,Jul,59.9,55.8,3100204,2891629,208575,6.7
2014,Aug,59.9,55.9,3109663,2901898,207765,6.7
2014,Sep,60,56,3119950,2912684,207266,6.6
2014,Oct,60.1,56.1,3129213,2922866,206347,6.6
2014,Nov,60.1,56.2,3136103,2931335,204768,6.5
2014,Dec,60.2,56.3,3141171,2938249,202922,6.5
2015,Jan,60.1,56.3,3143258,2941919,201339,6.4
2015,Feb,60.1,56.3,3146265,2947133,199132,6.3
2015,Mar,60.1,56.3,3149585,2952598,196987,6.3
2015,Apr,60.1,56.3,3153768,2958757,195011,6.2
2015,May,60.1,56.4,3158359,2965010,193349,6.1
2015,Jun,60,56.4,3162466,2970438,192028,6.1
2015,Jul,60,56.4,3165937,2974937,191000,6
2015,Aug,60,56.4,3169022,2979030,189992,6
2015,Sep,59.9,56.3,3172263,2983737,188526,5.9
2015,Oct,59.9,56.4,3176917,2990409,186508,5.9
2015,Nov,59.9,56.4,3183491,2999291,184200,5.8
2015,Dec,59.9,56.5,3191279,3009518,181761,5.7
2016,Jan,60,56.6,3199470,3019993,179477,5.6
2016,Feb,60.1,56.7,3207431,3029724,177707,5.5
2016,Mar,60.1,56.8,3214545,3038110,176435,5.5
2016,Apr,60.1,56.8,3220718,3045127,175591,5.5
2016,May,60.1,56.8,3226583,3051523,175060,5.4
2016,Jun,60.1,56.9,3232574,3058027,174547,5.4
2016,Jul,60.1,56.9,3238891,3065170,173721,5.4
2016,Aug,60.2,57,3245590,3072955,172635,5.3
2016,Sep,60.2,57,3252657,3081010,171647,5.3
2016,Oct,60.2,57.1,3259740,3088914,170826,5.2
2016,Nov,60.2,57.1,3266978,3097002,169976,5.2
2016,Dec,60.3,57.2,3274591,3105519,169072,5.2
2017,Jan,60.3,57.2,3282429,3114283,168146,5.1
2017,Feb,60.4,57.3,3290284,3123321,166963,5.1
2017,Mar,60.4,57.4,3297732,3132221,165511,5
2017,Apr,60.5,57.5,3305044,3141191,163853,5
2017,May,60.5,57.6,3312332,3150385,161947,4.9
2017,Jun,60.6,57.6,3319371,3159326,160045,4.8
2017,Jul,60.6,57.7,3326257,3167678,158579,4.8
2017,Aug,60.6,57.7,3332708,3174978,157730,4.7
2017,Sep,60.6,57.7,3338749,3181220,157529,4.7
2017,Oct,60.6,57.7,3344829,3186910,157919,4.7
2017,Nov,60.6,57.7,3351184,3192358,158826,4.7
2017,Dec,60.6,57.7,3358236,3198442,159794,4.8
2018,Jan,60.7,57.8,3366486,3205948,160538,4.8
2018,Feb,60.8,57.9,3376106,3215169,160937,4.8
2018,Mar,60.9,58,3386426,3225595,160831,4.7
2018,Apr,60.9,58.1,3396135,3235878,160257,4.7
2018,May,61,58.1,3404930,3245296,159634,4.7
2018,Jun,61.1,58.2,3413715,3254394,159321,4.7
2018,Jul,61.1,58.3,3423234,3263708,159526,4.7
2018,Aug,61.2,58.3,3434389,3273765,160624,4.7
2018,Sep,61.3,58.4,3447202,3284637,162565,4.7
2018,Oct,61.4,58.5,3460835,3295879,164956,4.8
2018,Nov,61.6,58.6,3474104,3306870,167234,4.8
2018,Dec,61.7,58.7,3485584,3316612,168972,4.8
2019,Jan,61.7,58.7,3494658,3324691,169967,4.9
2019,Feb,61.8,58.8,3501692,3331523,170169,4.9
2019,Mar,61.8,58.8,3508284,3338340,169944,4.8
2019,Apr,61.8,58.8,3516267,3346809,169458,4.8
2019,May,61.9,58.9,3526522,3357716,168806,4.8
2019,Jun,62,59.1,3539197,3371074,168123,4.8
2019,Jul,62.2,59.3,3555243,3388011,167232,4.7
2019,Aug,62.4,59.5,3571555,3405655,165900,4.6
2019,Sep,62.5,59.6,3585858,3421432,164426,4.6
2019,Oct,62.5,59.7,3595710,3432393,163317,4.5
2019,Nov,62.5,59.6,3596303,3433191,163112,4.5
2019,Dec,62.3,59.5,3594630,3431327,163303,4.5
2020,Jan,62.4,59.6,3604805,3442732,162073,4.5
2020,Feb,62.4,59.6,3613043,3451805,161238,4.5
2020,Mar,61.7,58,3578637,3359486,219151,6.1
2020,Apr,61,52.9,3543717,3069951,473766,13.4
2020,May,61.1,55.6,3552457,3233472,318985,9
2020,Jun,60.2,54.2,3509620,3158464,351156,10
2020,Jul,61.1,54.6,3565784,3185553,380231,10.7
2020,Aug,58.4,54.9,3414564,3212077,202487,5.9
2020,Sep,60.9,56.8,3566291,3328517,237774,6.7
