Year,Period,labor force participation rate,employment-population ratio,labor force,employment,unemployment,unemployment rate
1976,Jan,64.2,57.9,1443606,1302422,141184,9.8
1976,Feb,64.1,57.8,1442758,1301572,141186,9.8
1976,Mar,64,57.8,1442821,1301890,140931,9.8
1976,Apr,64.1,57.9,1446187,1306078,140109,9.7
1976,May,64.3,58.1,1451468,1312227,139241,9.6
1976,Jun,64.5,58.4,1457458,1319292,138166,9.5
1976,Jul,64.7,58.6,1462313,1325601,136712,9.3
1976,Aug,64.7,58.8,1465194,1330591,134603,9.2
1976,Sep,64.7,58.9,1466342,1334686,131656,9
1976,Oct,64.7,59,1466512,1338099,128413,8.8
1976,Nov,64.6,59.1,1466636,1341376,125260,8.5
1976,Dec,64.6,59.2,1467455,1345228,122227,8.3
1977,Jan,64.6,59.4,1469625,1350365,119260,8.1
1977,Feb,64.7,59.6,1472815,1356636,116179,7.9
1977,Mar,64.8,59.8,1475910,1363044,112866,7.6
1977,Apr,64.8,60,1478384,1368978,109406,7.4
1977,May,64.8,60.2,1480361,1374228,106133,7.2
1977,Jun,64.9,60.4,1482432,1379006,103426,7
1977,Jul,64.9,60.5,1485113,1383722,101391,6.8
1977,Aug,65,60.7,1488588,1388697,99891,6.7
1977,Sep,65.1,60.8,1492327,1394022,98305,6.6
1977,Oct,65.2,61,1495216,1399225,95991,6.4
1977,Nov,65.2,61.1,1496758,1403810,92948,6.2
1977,Dec,65.1,61.2,1497015,1407483,89532,6
1978,Jan,65.1,61.3,1496835,1410761,86074,5.8
1978,Feb,65,61.4,1497192,1414299,82893,5.5
1978,Mar,65,61.5,1498791,1418461,80330,5.4
1978,Apr,65.1,61.7,1501744,1423185,78559,5.2
1978,May,65.2,61.8,1505691,1428200,77491,5.1
1978,Jun,65.3,62,1509892,1433075,76817,5.1
1978,Jul,65.4,62.1,1513927,1437508,76419,5
1978,Aug,65.5,62.2,1518005,1441586,76419,5
1978,Sep,65.7,62.4,1522650,1445744,76906,5.1
1978,Oct,65.9,62.5,1528491,1450604,77887,5.1
1978,Nov,66.1,62.7,1535393,1456190,79203,5.2
1978,Dec,66.3,62.9,1542363,1461641,80722,5.2
1979,Jan,66.5,63,1548148,1465976,82172,5.3
1979,Feb,66.6,63.1,1552211,1469003,83208,5.4
1979,Mar,66.7,63.1,1554741,1471329,83412,5.4
1979,Apr,66.7,63.2,1556044,1473413,82631,5.3
1979,May,66.7,63.2,1557009,1475809,81200,5.2
1979,Jun,66.7,63.3,1558467,1478796,79671,5.1
1979,Jul,66.7,63.4,1560846,1482471,78375,5
1979,Aug,66.8,63.5,1564304,1486672,77632,5
1979,Sep,66.9,63.6,1568679,1490995,77684,5
1979,Oct,67,63.7,1573424,1495075,78349,5
1979,Nov,67.1,63.8,1577899,1498655,79244,5
1979,Dec,67.3,63.8,1581752,1501565,80187,5.1
1980,Jan,67.3,63.8,1584557,1503361,81196,5.1
1980,Feb,67.3,63.8,1586212,1503701,82511,5.2
1980,Mar,67.2,63.7,1587021,1502517,84504,5.3
1980,Apr,67.2,63.5,1587505,1500222,87283,5.5
1980,May,67.2,63.3,1587983,1497480,90503,5.7
1980,Jun,67.1,63.2,1588708,1495016,93692,5.9
1980,Jul,67.1,63,1589608,1493205,96403,6.1
1980,Aug,67,62.9,1590171,1492055,98116,6.2
1980,Sep,67,62.8,1590016,1491329,98687,6.2
1980,Oct,66.9,62.7,1589200,1490756,98444,6.2
1980,Nov,66.8,62.7,1588280,1490501,97779,6.2
1980,Dec,66.7,62.6,1588241,1491150,97091,6.1
1981,Jan,66.7,62.6,1589533,1492705,96828,6.1
1981,Feb,66.7,62.6,1591697,1494668,97029,6.1
1981,Mar,66.7,62.6,1594100,1496681,97419,6.1
1981,Apr,66.7,62.6,1596141,1498384,97757,6.1
1981,May,66.7,62.6,1597300,1499395,97905,6.1
1981,Jun,66.7,62.6,1597635,1499801,97834,6.1
1981,Jul,66.6,62.5,1597529,1499732,97797,6.1
1981,Aug,66.5,62.4,1597375,1499327,98048,6.1
1981,Sep,66.5,62.4,1597600,1498891,98709,6.2
1981,Oct,66.5,62.3,1598472,1498602,99870,6.2
1981,Nov,66.5,62.3,1599785,1498255,101530,6.3
1981,Dec,66.5,62.2,1601229,1497862,103367,6.5
1982,Jan,66.6,62.2,1602933,1497846,105087,6.6
1982,Feb,66.6,62.2,1605041,1498349,106692,6.6
1982,Mar,66.6,62.1,1607109,1499002,108107,6.7
1982,Apr,66.7,62.1,1608699,1499552,109147,6.8
1982,May,66.7,62.1,1609683,1499797,109886,6.8
1982,Jun,66.6,62.1,1609977,1499527,110450,6.9
1982,Jul,66.6,62,1609823,1498868,110955,6.9
1982,Aug,66.5,61.9,1609755,1498144,111611,6.9
1982,Sep,66.5,61.9,1610056,1497524,112532,7
1982,Oct,66.5,61.8,1610596,1497112,113484,7
1982,Nov,66.5,61.8,1611273,1497092,114181,7.1
1982,Dec,66.5,61.8,1611513,1497298,114215,7.1
1983,Jan,66.4,61.8,1610953,1497699,113254,7
1983,Feb,66.4,61.8,1610068,1498844,111224,6.9
1983,Mar,66.3,61.9,1609636,1501265,108371,6.7
1983,Apr,66.3,62,1610408,1505322,105086,6.5
1983,May,66.4,62.2,1612517,1510921,101596,6.3
1983,Jun,66.5,62.4,1615653,1517527,98126,6.1
1983,Jul,66.6,62.7,1619408,1524556,94852,5.9
1983,Aug,66.7,62.9,1623161,1531304,91857,5.7
1983,Sep,66.8,63.1,1626512,1537364,89148,5.5
1983,Oct,66.9,63.3,1629496,1542786,86710,5.3
1983,Nov,66.9,63.5,1632223,1547744,84479,5.2
1983,Dec,67,63.6,1635203,1552661,82542,5
1984,Jan,67.1,63.8,1638879,1558075,80804,4.9
1984,Feb,67.2,64,1643172,1564084,79088,4.8
1984,Mar,67.4,64.2,1647932,1570377,77555,4.7
1984,Apr,67.5,64.4,1652876,1576455,76421,4.6
1984,May,67.7,64.6,1657751,1581974,75777,4.6
1984,Jun,67.8,64.8,1662241,1586674,75567,4.5
1984,Jul,67.9,64.9,1666073,1590385,75688,4.5
1984,Aug,68,64.9,1669511,1593376,76135,4.6
1984,Sep,68.1,65,1673012,1596107,76905,4.6
1984,Oct,68.3,65.1,1677183,1599164,78019,4.7
1984,Nov,68.5,65.2,1682501,1603097,79404,4.7
1984,Dec,68.6,65.4,1688760,1607838,80922,4.8
1985,Jan,68.9,65.5,1695158,1612622,82536,4.9
1985,Feb,69.1,65.6,1700766,1616609,84157,4.9
1985,Mar,69.2,65.7,1704872,1619460,85412,5
1985,Apr,69.2,65.7,1707382,1621367,86015,5
1985,May,69.2,65.8,1708850,1622914,85936,5
1985,Jun,69.3,65.8,1710033,1624892,85141,5
1985,Jul,69.3,65.9,1711428,1627781,83647,4.9
1985,Aug,69.3,66,1713123,1631791,81332,4.7
1985,Sep,69.3,66.2,1714893,1636644,78249,4.6
1985,Oct,69.3,66.3,1716384,1641569,74815,4.4
1985,Nov,69.3,66.4,1717520,1645893,71627,4.2
1985,Dec,69.4,66.6,1718634,1649398,69236,4
1986,Jan,69.4,66.7,1720198,1652326,67872,3.9
1986,Feb,69.4,66.7,1722739,1655250,67489,3.9
1986,Mar,69.6,66.8,1726294,1658559,67735,3.9
1986,Apr,69.7,66.9,1730424,1662309,68115,3.9
1986,May,69.8,67.1,1734409,1666225,68184,3.9
1986,Jun,69.9,67.2,1737807,1670037,67770,3.9
1986,Jul,70,67.3,1740598,1673664,66934,3.8
1986,Aug,70,67.3,1742970,1676906,66064,3.8
1986,Sep,70.1,67.4,1745142,1679566,65576,3.8
1986,Oct,70.1,67.5,1747144,1681630,65514,3.7
1986,Nov,70.1,67.5,1748830,1683095,65735,3.8
1986,Dec,70.1,67.5,1750240,1684322,65918,3.8
1987,Jan,70.1,67.5,1751385,1685682,65703,3.8
1987,Feb,70.1,67.5,1752057,1687189,64868,3.7
1987,Mar,70.1,67.5,1752193,1688785,63408,3.6
1987,Apr,70,67.6,1751731,1690290,61441,3.5
1987,May,69.9,67.6,1750889,1691586,59303,3.4
1987,Jun,69.9,67.6,1750085,1692565,57520,3.3
1987,Jul,69.8,67.5,1749507,1693131,56376,3.2
1987,Aug,69.7,67.5,1749238,1693403,55835,3.2
1987,Sep,69.7,67.5,1749333,1693752,55581,3.2
1987,Oct,69.7,67.5,1749560,1694334,55226,3.2
1987,Nov,69.7,67.5,1749470,1695064,54406,3.1
1987,Dec,69.6,67.5,1748576,1695516,53060,3
1988,Jan,69.5,67.5,1746826,1695410,51416,2.9
1988,Feb,69.4,67.4,1744762,1694889,49873,2.9
1988,Mar,69.3,67.4,1743261,1694234,49027,2.8
1988,Apr,69.3,67.3,1743034,1693761,49273,2.8
1988,May,69.3,67.3,1744031,1693656,50375,2.9
1988,Jun,69.3,67.3,1745674,1693918,51756,3
1988,Jul,69.4,67.3,1747350,1694437,52913,3
1988,Aug,69.4,67.3,1748587,1695009,53578,3.1
1988,Sep,69.5,67.3,1749248,1695515,53733,3.1
1988,Oct,69.5,67.4,1749531,1696000,53531,3.1
1988,Nov,69.5,67.4,1749922,1696621,53301,3
1988,Dec,69.6,67.4,1750842,1697464,53378,3
1989,Jan,69.6,67.5,1752502,1698510,53992,3.1
1989,Feb,69.7,67.5,1754759,1699535,55224,3.1
1989,Mar,69.9,67.6,1757437,1700549,56888,3.2
1989,Apr,70,67.6,1760420,1701585,58835,3.3
1989,May,70.1,67.7,1763835,1702697,61138,3.5
1989,Jun,70.3,67.8,1767844,1704025,63819,3.6
1989,Jul,70.5,67.8,1772432,1705576,66856,3.8
1989,Aug,70.7,67.9,1777441,1707336,70105,3.9
1989,Sep,70.9,68,1782578,1709205,73373,4.1
1989,Oct,71.1,68,1787830,1711219,76611,4.3
1989,Nov,71.3,68.1,1793157,1713325,79832,4.5
1989,Dec,71.5,68.2,1798515,1715489,83026,4.6
1990,Jan,70.3,67,1803791,1717774,86017,4.8
1990,Feb,70.4,67,1808708,1720219,88489,4.9
1990,Mar,70.6,67,1812946,1722644,90302,5
1990,Apr,70.7,67.1,1816413,1724853,91560,5
1990,May,70.7,67.1,1819191,1726748,92443,5.1
1990,Jun,70.7,67.1,1821203,1728095,93108,5.1
1990,Jul,70.7,67.1,1822693,1728943,93750,5.1
1990,Aug,70.8,67.1,1823983,1729427,94556,5.2
1990,Sep,70.8,67.1,1825143,1729542,95601,5.2
1990,Oct,70.9,67.1,1826158,1729303,96855,5.3
1990,Nov,70.9,67.1,1827188,1729087,98101,5.4
1990,Dec,71,67.1,1828496,1729158,99338,5.4
1991,Jan,71.1,67.2,1830410,1729362,101048,5.5
1991,Feb,71.2,67.2,1833183,1729537,103646,5.7
1991,Mar,71.4,67.2,1836365,1729252,107113,5.8
1991,Apr,71.5,67.2,1839380,1728220,111160,6
1991,May,71.6,67.1,1841952,1726461,115491,6.3
1991,Jun,71.7,67.1,1844045,1724160,119885,6.5
1991,Jul,71.8,67,1845528,1721451,124077,6.7
1991,Aug,71.8,66.9,1846227,1718463,127764,6.9
1991,Sep,71.9,66.8,1846188,1715335,130853,7.1
1991,Oct,71.9,66.7,1845444,1712054,133390,7.2
1991,Nov,71.8,66.5,1843984,1708558,135426,7.3
1991,Dec,71.8,66.4,1841748,1704867,136881,7.4
1992,Jan,71.7,66.3,1838832,1701204,137628,7.5
1992,Feb,71.6,66.2,1835691,1697818,137873,7.5
1992,Mar,71.6,66.2,1833116,1695207,137909,7.5
1992,Apr,71.5,66.2,1831446,1693531,137915,7.5
1992,May,71.5,66.1,1830240,1692349,137891,7.5
1992,Jun,71.5,66.1,1829019,1691188,137831,7.5
1992,Jul,71.5,66.1,1827495,1689649,137846,7.5
1992,Aug,71.4,66,1825690,1687598,138092,7.6
1992,Sep,71.3,65.9,1823819,1685291,138528,7.6
1992,Oct,71.3,65.8,1822065,1683215,138850,7.6
1992,Nov,71.2,65.8,1820373,1681479,138894,7.6
1992,Dec,71.2,65.7,1818626,1680137,138489,7.6
1993,Jan,71.1,65.7,1816638,1679295,137343,7.6
1993,Feb,71,65.7,1814093,1678814,135279,7.5
1993,Mar,70.9,65.7,1810908,1678491,132417,7.3
1993,Apr,70.8,65.7,1807144,1678197,128947,7.1
1993,May,70.7,65.7,1803018,1677855,125163,6.9
1993,Jun,70.5,65.7,1798725,1677427,121298,6.7
1993,Jul,70.3,65.7,1794250,1676904,117346,6.5
1993,Aug,70.1,65.7,1789615,1676263,113352,6.3
1993,Sep,69.9,65.7,1784937,1675402,109535,6.1
1993,Oct,69.8,65.6,1780318,1674103,106215,6
1993,Nov,69.6,65.5,1775858,1672302,103556,5.8
1993,Dec,69.4,65.5,1771718,1670228,101490,5.7
1994,Jan,69.3,65.4,1767946,1667991,99955,5.7
1994,Feb,69.2,65.3,1764430,1665618,98812,5.6
1994,Mar,69.1,65.3,1761136,1663135,98001,5.6
1994,Apr,69,65.1,1758295,1660694,97601,5.6
1994,May,68.9,65.1,1756171,1658587,97584,5.6
1994,Jun,68.9,65,1754833,1656956,97877,5.6
1994,Jul,68.9,65,1754127,1655723,98404,5.6
1994,Aug,68.8,64.9,1753620,1654707,98913,5.6
1994,Sep,68.8,64.9,1752995,1653851,99144,5.7
1994,Oct,68.7,64.9,1752169,1653215,98954,5.6
1994,Nov,68.7,64.8,1751243,1652752,98491,5.6
1994,Dec,68.7,64.8,1749922,1651893,98029,5.6
1995,Jan,68.6,64.7,1747822,1650118,97704,5.6
1995,Feb,68.5,64.6,1745023,1647510,97513,5.6
1995,Mar,68.3,64.5,1741784,1644379,97405,5.6
1995,Apr,68.2,64.4,1738417,1641140,97277,5.6
1995,May,68.1,64.3,1735309,1638287,97022,5.6
1995,Jun,68,64.2,1732659,1636205,96454,5.6
1995,Jul,67.9,64.1,1730597,1635123,95474,5.5
1995,Aug,67.8,64.1,1729141,1634844,94297,5.5
1995,Sep,67.7,64.1,1728095,1634921,93174,5.4
1995,Oct,67.6,64,1727298,1634985,92313,5.3
1995,Nov,67.6,64,1726701,1634945,91756,5.3
1995,Dec,67.6,64,1726643,1635059,91584,5.3
1996,Jan,67.6,64,1727519,1635714,91805,5.3
1996,Feb,67.7,64.1,1729234,1636975,92259,5.3
1996,Mar,67.7,64.1,1731423,1638724,92699,5.4
1996,Apr,67.8,64.2,1733687,1640713,92974,5.4
1996,May,67.9,64.3,1735962,1642778,93184,5.4
1996,Jun,68,64.3,1738554,1644929,93625,5.4
1996,Jul,68.1,64.4,1741756,1647182,94574,5.4
1996,Aug,68.2,64.4,1745597,1649520,96077,5.5
1996,Sep,68.3,64.5,1749567,1651661,97906,5.6
1996,Oct,68.4,64.5,1752996,1653283,99713,5.7
1996,Nov,68.5,64.5,1755415,1654398,101017,5.8
1996,Dec,68.5,64.6,1756700,1655272,101428,5.8
1997,Jan,68.5,64.6,1757081,1656204,100877,5.7
1997,Feb,68.5,64.6,1757022,1657465,99557,5.7
1997,Mar,68.5,64.7,1756950,1659255,97695,5.6
1997,Apr,68.5,64.8,1757076,1661529,95547,5.4
1997,May,68.5,64.9,1757058,1663866,93192,5.3
1997,Jun,68.5,64.9,1756399,1665824,90575,5.2
1997,Jul,68.4,65,1754926,1667311,87615,5
1997,Aug,68.3,65,1752684,1668386,84298,4.8
1997,Sep,68.1,65,1750008,1669258,80750,4.6
1997,Oct,68,65,1747359,1670072,77287,4.4
1997,Nov,67.9,65,1744969,1670810,74159,4.2
1997,Dec,67.8,65,1742967,1671564,71403,4.1
1998,Jan,67.7,65.1,1741417,1672492,68925,4
1998,Feb,67.7,65.1,1740438,1673783,66655,3.8
1998,Mar,67.7,65.2,1739960,1675422,64538,3.7
1998,Apr,67.7,65.2,1739941,1677328,62613,3.6
1998,May,67.7,65.3,1740377,1679398,60979,3.5
1998,Jun,67.7,65.4,1741130,1681456,59674,3.4
1998,Jul,67.7,65.4,1741969,1683334,58635,3.4
1998,Aug,67.7,65.5,1742871,1685191,57680,3.3
1998,Sep,67.7,65.5,1743899,1687220,56679,3.3
1998,Oct,67.7,65.6,1744925,1689502,55423,3.2
1998,Nov,67.8,65.7,1745930,1691909,54021,3.1
1998,Dec,67.8,65.7,1746976,1694155,52821,3
1999,Jan,67.8,65.8,1748031,1696005,52026,3
1999,Feb,67.8,65.8,1749049,1697367,51682,3
1999,Mar,67.8,65.8,1749949,1698432,51517,2.9
1999,Apr,67.9,65.9,1750624,1699510,51114,2.9
1999,May,67.9,65.9,1751080,1700745,50335,2.9
1999,Jun,67.8,65.9,1751695,1702236,49459,2.8
1999,Jul,67.9,66,1752845,1703957,48888,2.8
1999,Aug,67.9,66,1754677,1705826,48851,2.8
1999,Sep,68,66.1,1757188,1707878,49310,2.8
1999,Oct,68.1,66.1,1760263,1710205,50058,2.8
1999,Nov,68.1,66.2,1763576,1712961,50615,2.9
1999,Dec,68.2,66.3,1766476,1716023,50453,2.9
2000,Jan,68.3,66.4,1768421,1719025,49396,2.8
2000,Feb,68.3,66.5,1769105,1721530,47575,2.7
2000,Mar,68.3,66.5,1768741,1723175,45566,2.6
2000,Apr,68.3,66.6,1767722,1723883,43839,2.5
2000,May,68.2,66.5,1766345,1723927,42418,2.4
2000,Jun,68.1,66.5,1764692,1723545,41147,2.3
2000,Jul,67.9,66.4,1762901,1722976,39925,2.3
2000,Aug,67.8,66.3,1761428,1722454,38974,2.2
2000,Sep,67.8,66.3,1760482,1721901,38581,2.2
2000,Oct,67.7,66.2,1760120,1721115,39005,2.2
2000,Nov,67.7,66.1,1760275,1719818,40457,2.3
2000,Dec,67.7,66,1760779,1717907,42872,2.4
2001,Jan,67.6,65.9,1761322,1715432,45890,2.6
2001,Feb,67.6,65.7,1761641,1712653,48988,2.8
2001,Mar,67.6,65.6,1761533,1709866,51667,2.9
2001,Apr,67.5,65.5,1760989,1707259,53730,3.1
2001,May,67.5,65.4,1760376,1705120,55256,3.1
2001,Jun,67.4,65.3,1759895,1703569,56326,3.2
2001,Jul,67.4,65.2,1759599,1702571,57028,3.2
2001,Aug,67.3,65.1,1759137,1701741,57396,3.3
2001,Sep,67.2,65,1758418,1700916,57502,3.3
2001,Oct,67.1,64.9,1757599,1700123,57476,3.3
2001,Nov,67.1,64.9,1756865,1699318,57547,3.3
2001,Dec,67,64.8,1756742,1698611,58131,3.3
2002,Jan,67,64.7,1757658,1698148,59510,3.4
2002,Feb,67.1,64.7,1759625,1697894,61731,3.5
2002,Mar,67.1,64.7,1762399,1697767,64632,3.7
2002,Apr,67.2,64.6,1765876,1697915,67961,3.8
2002,May,67.3,64.6,1769812,1698274,71538,4
2002,Jun,67.4,64.6,1773887,1698674,75213,4.2
2002,Jul,67.5,64.5,1777664,1698756,78908,4.4
2002,Aug,67.6,64.5,1780893,1698377,82516,4.6
2002,Sep,67.6,64.4,1783548,1697599,85949,4.8
2002,Oct,67.7,64.3,1785566,1696458,89108,5
2002,Nov,67.7,64.2,1787059,1695232,91827,5.1
2002,Dec,67.7,64.1,1787932,1694075,93857,5.2
2003,Jan,67.6,64,1788315,1693095,95220,5.3
2003,Feb,67.6,64,1788459,1692353,96106,5.4
2003,Mar,67.6,63.9,1788361,1691673,96688,5.4
2003,Apr,67.5,63.9,1787706,1690615,97091,5.4
2003,May,67.4,63.8,1786375,1688997,97378,5.5
2003,Jun,67.3,63.7,1784799,1687216,97583,5.5
2003,Jul,67.2,63.5,1783360,1685753,97607,5.5
2003,Aug,67.2,63.5,1782190,1684848,97342,5.5
2003,Sep,67.1,63.4,1781226,1684497,96729,5.4
2003,Oct,67,63.4,1780341,1684525,95816,5.4
2003,Nov,66.9,63.4,1779369,1684637,94732,5.3
2003,Dec,66.9,63.4,1778195,1684571,93624,5.3
2004,Jan,66.8,63.3,1776744,1684167,92577,5.2
2004,Feb,66.7,63.3,1775160,1683538,91622,5.2
2004,Mar,66.7,63.3,1773913,1683092,90821,5.1
2004,Apr,66.6,63.2,1773222,1683146,90076,5.1
2004,May,66.6,63.2,1772961,1683717,89244,5
2004,Jun,66.5,63.2,1772845,1684619,88226,5
2004,Jul,66.5,63.3,1772808,1685739,87069,4.9
2004,Aug,66.5,63.3,1772904,1686937,85967,4.8
2004,Sep,66.5,63.3,1773178,1688034,85144,4.8
2004,Oct,66.5,63.3,1773757,1689007,84750,4.8
2004,Nov,66.5,63.3,1774882,1690028,84854,4.8
2004,Dec,66.5,63.3,1776896,1691380,85516,4.8
2005,Jan,66.6,63.4,1779873,1693271,86602,4.9
2005,Feb,66.8,63.5,1783510,1695666,87844,4.9
2005,Mar,66.9,63.6,1787346,1698453,88893,5
2005,Apr,67,63.7,1791090,1701561,89529,5
2005,May,67.1,63.8,1794597,1704928,89669,5
2005,Jun,67.2,63.9,1797654,1708283,89371,5
2005,Jul,67.3,63.9,1800098,1711312,88786,4.9
2005,Aug,67.3,64,1802042,1714060,87982,4.9
2005,Sep,67.3,64.1,1803819,1716835,86984,4.8
2005,Oct,67.3,64.1,1805787,1719961,85826,4.8
2005,Nov,67.3,64.2,1808090,1723561,84529,4.7
2005,Dec,67.4,64.3,1810621,1727536,83085,4.6
2006,Jan,67.5,64.4,1813299,1731745,81554,4.5
2006,Feb,67.5,64.5,1816031,1735885,80146,4.4
2006,Mar,67.6,64.7,1818754,1739630,79124,4.4
2006,Apr,67.7,64.8,1821409,1742733,78676,4.3
2006,May,67.8,64.8,1823953,1745232,78721,4.3
2006,Jun,67.8,64.9,1826406,1747362,79044,4.3
2006,Jul,67.9,64.9,1829038,1749651,79387,4.3
2006,Aug,68,65,1832045,1752416,79629,4.3
2006,Sep,68.1,65.1,1835301,1755565,79736,4.3
2006,Oct,68.1,65.2,1838596,1758949,79647,4.3
2006,Nov,68.2,65.3,1841681,1762267,79414,4.3
2006,Dec,68.3,65.4,1844273,1765109,79164,4.3
2007,Jan,68.3,65.4,1846260,1767230,79030,4.3
2007,Feb,68.4,65.5,1847816,1768730,79086,4.3
2007,Mar,68.4,65.5,1848998,1769738,79260,4.3
2007,Apr,68.4,65.5,1850015,1770521,79494,4.3
2007,May,68.4,65.5,1851208,1771338,79870,4.3
2007,Jun,68.5,65.5,1852890,1772339,80551,4.3
2007,Jul,68.5,65.5,1855154,1773480,81674,4.4
2007,Aug,68.6,65.5,1857947,1774702,83245,4.5
2007,Sep,68.6,65.5,1861171,1776076,85095,4.6
2007,Oct,68.7,65.5,1864606,1777437,87169,4.7
2007,Nov,68.8,65.5,1867889,1778672,89217,4.8
2007,Dec,68.9,65.5,1870720,1779735,90985,4.9
2008,Jan,68.9,65.5,1872881,1780413,92468,4.9
2008,Feb,68.9,65.5,1874363,1780566,93797,5
2008,Mar,68.9,65.4,1875493,1780163,95330,5.1
2008,Apr,68.9,65.3,1876660,1779214,97446,5.2
2008,May,68.9,65.3,1878160,1777870,100290,5.3
2008,Jun,69,65.2,1880149,1776403,103746,5.5
2008,Jul,69,65.1,1882470,1774948,107522,5.7
2008,Aug,69,65,1884779,1773463,111316,5.9
2008,Sep,69.1,64.9,1886694,1771746,114948,6.1
2008,Oct,69.1,64.7,1887938,1769593,118345,6.3
2008,Nov,69,64.6,1888455,1766692,121763,6.4
2008,Dec,69,64.4,1888392,1762885,125507,6.6
2009,Jan,68.9,64.2,1887932,1758319,129613,6.9
2009,Feb,68.9,64,1887508,1753494,134014,7.1
2009,Mar,68.9,63.8,1887631,1749195,138436,7.3
2009,Apr,68.9,63.7,1888492,1745913,142579,7.5
2009,May,68.9,63.5,1889805,1743458,146347,7.7
2009,Jun,68.9,63.4,1891243,1741507,149736,7.9
2009,Jul,68.9,63.3,1892510,1739692,152818,8.1
2009,Aug,68.9,63.2,1893368,1737584,155784,8.2
2009,Sep,68.8,63.1,1893831,1734997,158834,8.4
2009,Oct,68.8,62.9,1893878,1731954,161924,8.5
2009,Nov,68.8,62.8,1893983,1729069,164914,8.7
2009,Dec,68.8,62.7,1894857,1727215,167642,8.8
2010,Jan,68.8,62.6,1896872,1726968,169904,9
2010,Feb,68.9,62.6,1899771,1728256,171515,9
2010,Mar,69,62.7,1903190,1730684,172506,9.1
2010,Apr,68,61.9,1906859,1733838,173021,9.1
2010,May,68.1,61.9,1910490,1737260,173230,9.1
2010,Jun,68.2,62,1913669,1740215,173454,9.1
2010,Jul,68.2,62,1916044,1742076,173968,9.1
2010,Aug,68.2,62,1917663,1742854,174809,9.1
2010,Sep,68.2,61.9,1918752,1742905,175847,9.2
2010,Oct,68.2,61.9,1919693,1742799,176894,9.2
2010,Nov,68.2,61.9,1920583,1742922,177661,9.3
2010,Dec,68.2,61.8,1921281,1743364,177917,9.3
2011,Jan,68.1,61.8,1921839,1744160,177679,9.2
2011,Feb,68.1,61.8,1921980,1744996,176984,9.2
2011,Mar,68.1,61.8,1921262,1745441,175821,9.2
2011,Apr,68,61.8,1919579,1745305,174274,9.1
2011,May,67.8,61.7,1917323,1744842,172481,9
2011,Jun,67.7,61.7,1915006,1744519,170487,8.9
2011,Jul,67.6,61.7,1913148,1744791,168357,8.8
2011,Aug,67.5,61.7,1911831,1745675,166156,8.7
2011,Sep,67.4,61.7,1910755,1746903,163852,8.6
2011,Oct,67.4,61.7,1909728,1748159,161569,8.5
2011,Nov,67.3,61.7,1908451,1748916,159535,8.4
2011,Dec,67.2,61.6,1906593,1748647,157946,8.3
2012,Jan,67.1,61.6,1904057,1747131,156926,8.2
2012,Feb,67,61.4,1901053,1744475,156578,8.2
2012,Mar,66.8,61.3,1897790,1740795,156995,8.3
2012,Apr,66.7,61.1,1894278,1736266,158012,8.3
2012,May,66.5,60.9,1890828,1731589,159239,8.4
2012,Jun,66.4,60.7,1887726,1727535,160191,8.5
2012,Jul,66.2,60.6,1885184,1724752,160432,8.5
2012,Aug,66.1,60.5,1883167,1723301,159866,8.5
2012,Sep,66.1,60.5,1881296,1722549,158747,8.4
2012,Oct,65.9,60.4,1878778,1721522,157256,8.4
2012,Nov,65.8,60.3,1875155,1719640,155515,8.3
2012,Dec,65.6,60.2,1870703,1716939,153764,8.2
2013,Jan,65.4,60.1,1866104,1713860,152244,8.2
2013,Feb,65.3,60,1862393,1711389,151004,8.1
2013,Mar,65.2,60,1860344,1710431,149913,8.1
2013,Apr,65.2,60,1860317,1711456,148861,8
2013,May,65.2,60,1861705,1713811,147894,7.9
2013,Jun,65.3,60.1,1863418,1716463,146955,7.9
2013,Jul,65.3,60.2,1864609,1718658,145951,7.8
2013,Aug,65.3,60.2,1864989,1720349,144640,7.8
2013,Sep,65.2,60.2,1865002,1722150,142852,7.7
2013,Oct,65.2,60.3,1865500,1724658,140842,7.5
2013,Nov,65.3,60.4,1867073,1728285,138788,7.4
2013,Dec,65.3,60.6,1869727,1733041,136686,7.3
2014,Jan,65.3,60.7,1870139,1736172,133967,7.2
2014,Feb,65.4,60.8,1873306,1741488,131818,7
2014,Mar,65.5,61,1876503,1746729,129774,6.9
2014,Apr,65.6,61.2,1879504,1751638,127866,6.8
2014,May,65.7,61.3,1882429,1756345,126084,6.7
2014,Jun,65.8,61.4,1885754,1761165,124589,6.6
2014,Jul,65.9,61.6,1889431,1765985,123446,6.5
2014,Aug,66,61.7,1893216,1770665,122551,6.5
2014,Sep,66.1,61.9,1896814,1775082,121732,6.4
2014,Oct,66.2,62,1899772,1779108,120664,6.4
2014,Nov,66.3,62.1,1901754,1782489,119265,6.3
2014,Dec,66.3,62.2,1902795,1785104,117691,6.2
2015,Jan,66.3,62.3,1902592,1786748,115844,6.1
2015,Feb,66.3,62.3,1901733,1787720,114013,6
2015,Mar,66.2,62.3,1899832,1787695,112137,5.9
2015,Apr,66.1,62.3,1896966,1786668,110298,5.8
2015,May,66,62.2,1893306,1784745,108561,5.7
2015,Jun,65.8,62.1,1889106,1782120,106986,5.7
2015,Jul,65.7,62,1885082,1779287,105795,5.6
2015,Aug,65.5,61.9,1881888,1776763,105125,5.6
2015,Sep,65.5,61.8,1879744,1774936,104808,5.6
2015,Oct,65.4,61.8,1878867,1774216,104651,5.6
2015,Nov,65.4,61.8,1879195,1774740,104455,5.6
2015,Dec,65.5,61.8,1880209,1776264,103945,5.5
2016,Jan,65.5,61.9,1881587,1778448,103139,5.5
2016,Feb,65.6,62,1883269,1781074,102195,5.4
2016,Mar,65.6,62.1,1885281,1784062,101219,5.4
2016,Apr,65.7,62.2,1887611,1787256,100355,5.3
2016,May,65.8,62.3,1890173,1790551,99622,5.3
2016,Jun,65.9,62.4,1892592,1793792,98800,5.2
2016,Jul,65.9,62.5,1894467,1796841,97626,5.2
2016,Aug,66,62.6,1895782,1799624,96158,5.1
2016,Sep,66,62.7,1896838,1802158,94680,5
2016,Oct,66,62.8,1897845,1804511,93334,4.9
2016,Nov,66.1,62.8,1899217,1806906,92311,4.9
2016,Dec,66.1,62.9,1901230,1809412,91818,4.8
2017,Jan,66.2,63,1903526,1811745,91781,4.8
2017,Feb,66.3,63.1,1905362,1813502,91860,4.8
2017,Mar,66.3,63.1,1905939,1814156,91783,4.8
2017,Apr,66.2,63.1,1905002,1813667,91335,4.8
2017,May,66.2,63,1902767,1812276,90491,4.8
2017,Jun,66,62.9,1899739,1810231,89508,4.7
2017,Jul,65.9,62.8,1896542,1807896,88646,4.7
2017,Aug,65.8,62.7,1893535,1805569,87966,4.6
2017,Sep,65.7,62.7,1891058,1803573,87485,4.6
2017,Oct,65.6,62.6,1889371,1802204,87167,4.6
2017,Nov,65.6,62.6,1888351,1801515,86836,4.6
2017,Dec,65.6,62.6,1887951,1801694,86257,4.6
2018,Jan,65.6,62.6,1888333,1802920,85413,4.5
2018,Feb,65.6,62.7,1889624,1805271,84353,4.5
2018,Mar,65.7,62.8,1891731,1808623,83108,4.4
2018,Apr,65.7,62.9,1894234,1812494,81740,4.3
2018,May,65.8,63,1896821,1816459,80362,4.2
2018,Jun,65.9,63.2,1899539,1820549,78990,4.2
2018,Jul,66,63.3,1902384,1824743,77641,4.1
2018,Aug,66.1,63.4,1905267,1828804,76463,4
2018,Sep,66.2,63.5,1907801,1832288,75513,4
2018,Oct,66.2,63.6,1909496,1834684,74812,3.9
2018,Nov,66.2,63.7,1909960,1835758,74202,3.9
2018,Dec,66.2,63.6,1908987,1835491,73496,3.9
2019,Jan,66.1,63.6,1906788,1834176,72612,3.8
2019,Feb,66,63.6,1904004,1832424,71580,3.8
2019,Mar,66,63.5,1901736,1831118,70618,3.7
2019,Apr,65.9,63.5,1901072,1831159,69913,3.7
2019,May,66,63.6,1902550,1832938,69612,3.7
2019,Jun,66.1,63.7,1906099,1836251,69848,3.7
2019,Jul,66.3,63.9,1911681,1841106,70575,3.7
2019,Aug,66.5,64,1917687,1846263,71424,3.7
2019,Sep,66.7,64.2,1923109,1851012,72097,3.7
2019,Oct,66.8,64.3,1926753,1854295,72458,3.8
2019,Nov,66.8,64.3,1926916,1854543,72373,3.8
2019,Dec,66.8,64.3,1926276,1853997,72279,3.8
2020,Jan,66.9,64.4,1929340,1857116,72224,3.7
2020,Feb,66.9,64.4,1930453,1857872,72581,3.8
2020,Mar,66.9,64.6,1930836,1865216,65620,3.4
2020,Apr,61.6,56.5,1776603,1629265,147338,8.3
2020,May,61.6,55.7,1777004,1606697,170307,9.6
2020,Jun,65.1,58.6,1879811,1690747,189064,10.1
2020,Jul,65.8,59.1,1900497,1706203,194294,10.2
2020,Aug,64.7,59.4,1866403,1715588,150815,8.1
2020,Sep,65.6,60.5,1894773,1747656,147117,7.8
