Year,Period,labor force participation rate,employment-population ratio,labor force,employment,unemployment,unemployment rate
1976,Jan,63.2,58.9,5133491,4788469,345022,6.7
1976,Feb,63.1,58.8,5132066,4787725,344341,6.7
1976,Mar,63,58.8,5131818,4789790,342028,6.7
1976,Apr,63,58.8,5135150,4796640,338510,6.6
1976,May,63,58.9,5141327,4804591,336736,6.5
1976,Jun,63,58.9,5148731,4811721,337010,6.5
1976,Jul,63,58.8,5154904,4815656,339248,6.6
1976,Aug,63,58.8,5159514,4817462,342052,6.6
1976,Sep,62.9,58.8,5161664,4819299,342365,6.6
1976,Oct,62.9,58.8,5162302,4822883,339419,6.6
1976,Nov,62.8,58.8,5163967,4830097,333870,6.5
1976,Dec,62.8,58.9,5169396,4842649,326747,6.3
1977,Jan,62.9,59,5181856,4861433,320423,6.2
1977,Feb,63.1,59.3,5201026,4884765,316261,6.1
1977,Mar,63.3,59.5,5223076,4908178,314898,6
1977,Apr,63.5,59.7,5245102,4928603,316499,6
1977,May,63.7,59.8,5265352,4944440,320912,6.1
1977,Jun,63.8,59.9,5283181,4955641,327540,6.2
1977,Jul,63.9,59.9,5298086,4964523,333563,6.3
1977,Aug,64,60,5311995,4974415,337580,6.4
1977,Sep,64.2,60.1,5327223,4987142,340081,6.4
1977,Oct,64.3,60.2,5342744,5001735,341009,6.4
1977,Nov,64.4,60.3,5357147,5016340,340807,6.4
1977,Dec,64.5,60.4,5369423,5028504,340919,6.3
1978,Jan,64.6,60.5,5379483,5038595,340888,6.3
1978,Feb,64.6,60.6,5388092,5048100,339992,6.3
1978,Mar,64.7,60.6,5396456,5058245,338211,6.3
1978,Apr,64.7,60.7,5404670,5069425,335245,6.2
1978,May,64.8,60.8,5413243,5082006,331237,6.1
1978,Jun,64.8,60.9,5422060,5096035,326025,6
1978,Jul,64.9,61,5430839,5109904,320935,5.9
1978,Aug,64.9,61.1,5438582,5121852,316730,5.8
1978,Sep,65,61.2,5444403,5131592,312811,5.7
1978,Oct,65,61.3,5449656,5139995,309661,5.7
1978,Nov,65,61.4,5454292,5146787,307505,5.6
1978,Dec,65,61.4,5455519,5149603,305916,5.6
1979,Jan,64.9,61.3,5450816,5146556,304260,5.6
1979,Feb,64.8,61.2,5441129,5139335,301794,5.5
1979,Mar,64.6,61.1,5429335,5132116,297219,5.5
1979,Apr,64.4,61,5418993,5128267,290726,5.4
1979,May,64.3,61,5413890,5129683,284207,5.2
1979,Jun,64.3,61,5415706,5135092,280614,5.2
1979,Jul,64.4,61.1,5424660,5143098,281562,5.2
1979,Aug,64.6,61.1,5440509,5152362,288147,5.3
1979,Sep,64.8,61.2,5461423,5160998,300425,5.5
1979,Oct,65,61.3,5483015,5167243,315772,5.8
1979,Nov,65.2,61.3,5501644,5170104,331540,6
1979,Dec,65.3,61.2,5516566,5169767,346799,6.3
1980,Jan,65.4,61.1,5527858,5165643,362215,6.6
1980,Feb,65.5,61,5536017,5156497,379520,6.9
1980,Mar,65.5,60.8,5542657,5142025,400632,7.2
1980,Apr,65.6,60.6,5548404,5124072,424332,7.6
1980,May,65.6,60.3,5553271,5105610,447661,8.1
1980,Jun,65.6,60.1,5558454,5090240,468214,8.4
1980,Jul,65.6,59.9,5563157,5079298,483859,8.7
1980,Aug,65.6,59.8,5565343,5072084,493259,8.9
1980,Sep,65.6,59.7,5564825,5067712,497113,8.9
1980,Oct,65.5,59.7,5563804,5065969,497835,8.9
1980,Nov,65.5,59.7,5565128,5068386,496742,8.9
1980,Dec,65.5,59.7,5571678,5077315,494363,8.9
1981,Jan,65.6,59.9,5582922,5091853,491069,8.8
1981,Feb,65.7,60,5595042,5108897,486145,8.7
1981,Mar,65.8,60.2,5604814,5125962,478852,8.5
1981,Apr,65.8,60.3,5609822,5138889,470933,8.4
1981,May,65.8,60.3,5608659,5144243,464416,8.3
1981,Jun,65.7,60.3,5602645,5142340,460305,8.2
1981,Jul,65.5,60.2,5594668,5134632,460036,8.2
1981,Aug,65.4,60,5587195,5123127,464068,8.3
1981,Sep,65.4,59.8,5581621,5110122,471499,8.4
1981,Oct,65.3,59.7,5578844,5097157,481687,8.6
1981,Nov,65.3,59.5,5577876,5083402,494474,8.9
1981,Dec,65.3,59.3,5578264,5068972,509292,9.1
1982,Jan,65.3,59.1,5580562,5055467,525095,9.4
1982,Feb,65.3,59,5585896,5042708,543188,9.7
1982,Mar,65.4,58.8,5593258,5028883,564375,10.1
1982,Apr,65.5,58.6,5602371,5014575,587796,10.5
1982,May,65.6,58.5,5612012,5000438,611574,10.9
1982,Jun,65.7,58.3,5619553,4985310,634243,11.3
1982,Jul,65.7,58.1,5624942,4969292,655650,11.7
1982,Aug,65.8,57.9,5628996,4953377,675619,12
1982,Sep,65.8,57.7,5631690,4937858,693832,12.3
1982,Oct,65.8,57.5,5632545,4922745,709800,12.6
1982,Nov,65.8,57.3,5631608,4909014,722594,12.8
1982,Dec,65.7,57.1,5626818,4896003,730815,13
1983,Jan,65.6,57,5618866,4884183,734683,13.1
1983,Feb,65.5,56.9,5610337,4877115,733222,13.1
1983,Mar,65.4,56.9,5603485,4877393,726092,13
1983,Apr,65.3,57,5601070,4886331,714739,12.8
1983,May,65.3,57.2,5602934,4902836,700098,12.5
1983,Jun,65.4,57.4,5606672,4924334,682338,12.2
1983,Jul,65.4,57.7,5609314,4948113,661201,11.8
1983,Aug,65.4,57.9,5608591,4970550,638041,11.4
1983,Sep,65.3,58.1,5604274,4989517,614757,11
1983,Oct,65.2,58.3,5597655,5004881,592774,10.6
1983,Nov,65.1,58.4,5591246,5016965,574281,10.3
1983,Dec,65,58.5,5588584,5028028,560556,10
1984,Jan,65,58.6,5590739,5041504,549235,9.8
1984,Feb,65.1,58.8,5596241,5058549,537692,9.6
1984,Mar,65.1,59,5603039,5077329,525710,9.4
1984,Apr,65.1,59.2,5607121,5094128,512993,9.1
1984,May,65.1,59.3,5608292,5106724,501568,8.9
1984,Jun,65.1,59.4,5607841,5114630,493211,8.8
1984,Jul,65.1,59.4,5606449,5118074,488375,8.7
1984,Aug,65.1,59.4,5607211,5119214,487997,8.7
1984,Sep,65.1,59.4,5612325,5120651,491674,8.8
1984,Oct,65.2,59.4,5621908,5125314,496594,8.8
1984,Nov,65.4,59.6,5635515,5135571,499944,8.9
1984,Dec,65.5,59.7,5650959,5149963,500996,8.9
1985,Jan,65.7,59.9,5664267,5162968,501299,8.9
1985,Feb,65.8,59.9,5672272,5169385,502887,8.9
1985,Mar,65.8,59.9,5673445,5167793,505652,8.9
1985,Apr,65.7,59.8,5669458,5160193,509265,9
1985,May,65.6,59.7,5663832,5150153,513679,9.1
1985,Jun,65.6,59.6,5660394,5141738,518656,9.2
1985,Jul,65.6,59.5,5661764,5138149,523615,9.2
1985,Aug,65.6,59.5,5666971,5141938,525033,9.3
1985,Sep,65.7,59.6,5673838,5152005,521833,9.2
1985,Oct,65.7,59.7,5680545,5164156,516389,9.1
1985,Nov,65.7,59.8,5684173,5174331,509842,9
1985,Dec,65.7,59.9,5683345,5180479,502866,8.8
1986,Jan,65.6,59.9,5680413,5183639,496774,8.7
1986,Feb,65.6,59.9,5679345,5186958,492387,8.7
1986,Mar,65.6,59.9,5682147,5192710,489437,8.6
1986,Apr,65.6,60,5689055,5201679,487376,8.6
1986,May,65.7,60.1,5697582,5213107,484475,8.5
1986,Jun,65.7,60.2,5705168,5225438,479730,8.4
1986,Jul,65.8,60.3,5709817,5236739,473078,8.3
1986,Aug,65.7,60.4,5710298,5244677,465621,8.2
1986,Sep,65.7,60.4,5707015,5248652,458363,8
1986,Oct,65.5,60.4,5701150,5249593,451557,7.9
1986,Nov,65.4,60.3,5694792,5248165,446627,7.8
1986,Dec,65.4,60.3,5692168,5247800,444368,7.8
1987,Jan,65.4,60.3,5695609,5251060,444549,7.8
1987,Feb,65.4,60.3,5704391,5258662,445729,7.8
1987,Mar,65.5,60.4,5718115,5271571,446544,7.8
1987,Apr,65.7,60.6,5733928,5288616,445312,7.8
1987,May,65.8,60.8,5748805,5307857,440948,7.7
1987,Jun,65.9,61,5761512,5327448,434064,7.5
1987,Jul,66,61.1,5771319,5345431,425888,7.4
1987,Aug,66,61.3,5778520,5360287,418233,7.2
1987,Sep,66.1,61.4,5784488,5372267,412221,7.1
1987,Oct,66.1,61.5,5790428,5381636,408792,7.1
1987,Nov,66.2,61.5,5796888,5389223,407665,7
1987,Dec,66.2,61.5,5802000,5394076,407924,7
1988,Jan,66.2,61.5,5803724,5395933,407791,7
1988,Feb,66.1,61.5,5802656,5396509,406147,7
1988,Mar,66.1,61.5,5800805,5397563,403242,7
1988,Apr,66.1,61.5,5801559,5402075,399484,6.9
1988,May,66.1,61.6,5807182,5412010,395172,6.8
1988,Jun,66.2,61.8,5818407,5427535,390872,6.7
1988,Jul,66.4,62,5835653,5448491,387162,6.6
1988,Aug,66.6,62.2,5857983,5473537,384446,6.6
1988,Sep,66.8,62.5,5882772,5500643,382129,6.5
1988,Oct,67.1,62.8,5906870,5528359,378511,6.4
1988,Nov,67.3,63.1,5928582,5555740,372842,6.3
1988,Dec,67.5,63.4,5947157,5581684,365473,6.1
1989,Jan,67.7,63.6,5963500,5605659,357841,6
1989,Feb,67.8,63.8,5977693,5625843,351850,5.9
1989,Mar,67.9,64,5988792,5641204,347588,5.8
1989,Apr,68,64,5996460,5651070,345390,5.8
1989,May,68,64.1,6001567,5655388,346179,5.8
1989,Jun,68,64,6004903,5654824,350079,5.8
1989,Jul,68,64,6006284,5649410,356874,5.9
1989,Aug,68,63.8,6005738,5640768,364970,6.1
1989,Sep,67.9,63.7,6003405,5631272,372133,6.2
1989,Oct,67.8,63.6,6000211,5623373,376838,6.3
1989,Nov,67.8,63.5,5995716,5617681,378035,6.3
1989,Dec,67.7,63.4,5989706,5614040,375666,6.3
1990,Jan,69.3,65.1,5981491,5611552,369939,6.2
1990,Feb,69.1,64.9,5970712,5608796,361916,6.1
1990,Mar,68.9,64.8,5958987,5604177,354810,6
1990,Apr,68.6,64.6,5948328,5596690,351638,5.9
1990,May,68.4,64.3,5940998,5587470,353528,6
1990,Jun,68.3,64.1,5937183,5577951,359232,6.1
1990,Jul,68.2,64,5936671,5570512,366159,6.2
1990,Aug,68.2,63.9,5938210,5565824,372386,6.3
1990,Sep,68.1,63.8,5939163,5562434,376729,6.3
1990,Oct,68.1,63.7,5938254,5559094,379160,6.4
1990,Nov,68,63.6,5936741,5556420,380321,6.4
1990,Dec,67.9,63.6,5935721,5554447,381274,6.4
1991,Jan,67.9,63.5,5935758,5551641,384117,6.5
1991,Feb,67.9,63.4,5937775,5548073,389702,6.6
1991,Mar,67.9,63.4,5939862,5542934,396928,6.7
1991,Apr,67.9,63.2,5940157,5536039,404118,6.8
1991,May,67.8,63.1,5938408,5527990,410418,6.9
1991,Jun,67.7,63,5935879,5519302,416577,7
1991,Jul,67.7,62.8,5934525,5509685,424840,7.2
1991,Aug,67.7,62.7,5936615,5499911,436704,7.4
1991,Sep,67.7,62.5,5944191,5491747,452444,7.6
1991,Oct,67.7,62.4,5956223,5485884,470339,7.9
1991,Nov,67.9,62.3,5969882,5482821,487061,8.2
1991,Dec,68,62.3,5982596,5482949,499647,8.4
1992,Jan,68,62.3,5993989,5487199,506790,8.5
1992,Feb,68.1,62.4,6004398,5495382,509016,8.5
1992,Mar,68.2,62.5,6015227,5507752,507475,8.4
1992,Apr,68.3,62.6,6027228,5523487,503741,8.4
1992,May,68.4,62.7,6037456,5539780,497676,8.2
1992,Jun,68.4,62.9,6043343,5555029,488314,8.1
1992,Jul,68.3,63,6044649,5568969,475680,7.9
1992,Aug,68.2,63,6041715,5580379,461336,7.6
1992,Sep,68.1,63,6035975,5587479,448496,7.4
1992,Oct,68,63,6030371,5590132,440239,7.3
1992,Nov,67.9,62.9,6026756,5587929,438827,7.3
1992,Dec,67.8,62.8,6026510,5582543,443967,7.4
1993,Jan,67.8,62.7,6030359,5577350,453009,7.5
1993,Feb,67.8,62.6,6037566,5574958,462608,7.7
1993,Mar,67.9,62.6,6047369,5577596,469773,7.8
1993,Apr,68,62.7,6058471,5585815,472656,7.8
1993,May,68.1,62.8,6070103,5597871,472232,7.8
1993,Jun,68.1,62.9,6080994,5611343,469651,7.7
1993,Jul,68.1,63,6088057,5624196,463861,7.6
1993,Aug,68.1,63,6091205,5636366,454839,7.5
1993,Sep,68.1,63.1,6092782,5649146,443636,7.3
1993,Oct,68.1,63.2,6094454,5662291,432163,7.1
1993,Nov,68.1,63.4,6097013,5674944,422069,6.9
1993,Dec,68.1,63.5,6100111,5687275,412836,6.8
1994,Jan,68.1,63.6,6101856,5699115,402741,6.6
1994,Feb,68,63.7,6100723,5709701,391022,6.4
1994,Mar,68,63.7,6097199,5718376,378823,6.2
1994,Apr,67.9,63.8,6092954,5726024,366930,6
1994,May,67.8,63.9,6090808,5734624,356184,5.8
1994,Jun,67.8,63.9,6093077,5744841,348236,5.7
1994,Jul,67.8,64,6099941,5756268,343673,5.6
1994,Aug,67.9,64.1,6108875,5768247,340628,5.6
1994,Sep,68,64.2,6117223,5781134,336089,5.5
1994,Oct,68,64.4,6123827,5796007,327820,5.4
1994,Nov,68,64.5,6130474,5813398,317076,5.2
1994,Dec,68.1,64.7,6138463,5830245,308218,5
1995,Jan,68.2,64.8,6147030,5842877,304153,4.9
1995,Feb,68.2,64.9,6155478,5850507,304971,5
1995,Mar,68.3,64.9,6162415,5853051,309364,5
1995,Apr,68.3,64.8,6166548,5851199,315349,5.1
1995,May,68.3,64.8,6168412,5848054,320358,5.2
1995,Jun,68.3,64.7,6169533,5847071,322462,5.2
1995,Jul,68.3,64.7,6172104,5849867,322237,5.2
1995,Aug,68.3,64.7,6176998,5855541,321457,5.2
1995,Sep,68.3,64.8,6183530,5861723,321807,5.2
1995,Oct,68.3,64.8,6190234,5866491,323743,5.2
1995,Nov,68.3,64.7,6194979,5869321,325658,5.3
1995,Dec,68.3,64.7,6197805,5870953,326852,5.3
1996,Jan,68.4,64.7,6201349,5873160,328189,5.3
1996,Feb,68.4,64.8,6208014,5877235,330779,5.3
1996,Mar,68.5,64.8,6218408,5884200,334208,5.4
1996,Apr,68.6,64.9,6231030,5893748,337282,5.4
1996,May,68.7,64.9,6243466,5904544,338922,5.4
1996,Jun,68.7,65,6253660,5915471,338189,5.4
1996,Jul,68.8,65.1,6261105,5926243,334862,5.3
1996,Aug,68.8,65.2,6266495,5936670,329825,5.3
1996,Sep,68.8,65.2,6269711,5945094,324617,5.2
1996,Oct,68.7,65.2,6271503,5950270,321233,5.1
1996,Nov,68.7,65.2,6273219,5952830,320389,5.1
1996,Dec,68.7,65.2,6275472,5955179,320293,5.1
1997,Jan,68.7,65.2,6278422,5959410,319012,5.1
1997,Feb,68.7,65.3,6281418,5966112,315306,5
1997,Mar,68.7,65.4,6284193,5975503,308690,4.9
1997,Apr,68.8,65.5,6287855,5986729,301126,4.8
1997,May,68.8,65.5,6291638,5997048,294590,4.7
1997,Jun,68.8,65.6,6295146,6004697,290449,4.6
1997,Jul,68.8,65.6,6299557,6010198,289359,4.6
1997,Aug,68.8,65.6,6305490,6014181,291309,4.6
1997,Sep,68.8,65.6,6312571,6017720,294851,4.7
1997,Oct,68.8,65.6,6319902,6021190,298712,4.7
1997,Nov,68.8,65.6,6325104,6023994,301110,4.8
1997,Dec,68.8,65.5,6326650,6026305,300345,4.7
1998,Jan,68.7,65.5,6324384,6027860,296524,4.7
1998,Feb,68.7,65.5,6319684,6029714,289970,4.6
1998,Mar,68.6,65.5,6314406,6032651,281755,4.5
1998,Apr,68.5,65.5,6311880,6037913,273967,4.3
1998,May,68.5,65.6,6315685,6046421,269264,4.3
1998,Jun,68.6,65.6,6326235,6056815,269420,4.3
1998,Jul,68.7,65.7,6341067,6067299,273768,4.3
1998,Aug,68.8,65.8,6357874,6078419,279455,4.4
1998,Sep,68.9,65.9,6374831,6090854,283977,4.5
1998,Oct,69.1,66,6389050,6104642,284408,4.5
1998,Nov,69.1,66.1,6398996,6118827,280169,4.4
1998,Dec,69.1,66.2,6405913,6132028,273885,4.3
1999,Jan,69.2,66.3,6411849,6144070,267779,4.2
1999,Feb,69.2,66.4,6419760,6154461,265299,4.1
1999,Mar,69.3,66.4,6431613,6162949,268664,4.2
1999,Apr,69.4,66.5,6446056,6169877,276179,4.3
1999,May,69.6,66.5,6460608,6175611,284997,4.4
1999,Jun,69.6,66.5,6474018,6181741,292277,4.5
1999,Jul,69.7,66.5,6484806,6188637,296169,4.6
1999,Aug,69.8,66.6,6491757,6195986,295771,4.6
1999,Sep,69.7,66.6,6495719,6204065,291654,4.5
1999,Oct,69.7,66.7,6499013,6212799,286214,4.4
1999,Nov,69.8,66.7,6503998,6222591,281407,4.3
1999,Dec,69.8,66.8,6510267,6232245,278022,4.3
2000,Jan,69.8,66.9,6516094,6239476,276618,4.2
2000,Feb,69.8,66.9,6518962,6242388,276574,4.2
2000,Mar,69.8,66.8,6517873,6240306,277567,4.3
2000,Apr,69.8,66.8,6513433,6233854,279579,4.3
2000,May,69.7,66.7,6506021,6224796,281225,4.3
2000,Jun,69.6,66.5,6496077,6214470,281607,4.3
2000,Jul,69.4,66.4,6485284,6204277,281007,4.3
2000,Aug,69.3,66.3,6476765,6196136,280629,4.3
2000,Sep,69.2,66.2,6472215,6190685,281530,4.3
2000,Oct,69.1,66.1,6472347,6187872,284475,4.4
2000,Nov,69.1,66,6476902,6186095,290807,4.5
2000,Dec,69.2,66,6484014,6183626,300388,4.6
2001,Jan,69.2,65.9,6490801,6179455,311346,4.8
2001,Feb,69.2,65.8,6494515,6173485,321030,4.9
2001,Mar,69.2,65.7,6492605,6165471,327134,5
2001,Apr,69,65.5,6484184,6154759,329425,5.1
2001,May,68.9,65.3,6472068,6142287,329781,5.1
2001,Jun,68.7,65.2,6459193,6128517,330676,5.1
2001,Jul,68.5,65,6448283,6114115,334168,5.2
2001,Aug,68.4,64.8,6439518,6097509,342009,5.3
2001,Sep,68.3,64.5,6432465,6078229,354236,5.5
2001,Oct,68.2,64.2,6426471,6057789,368682,5.7
2001,Nov,68.1,64,6419973,6037149,382824,6
2001,Dec,68,63.8,6413132,6018004,395128,6.2
2002,Jan,67.9,63.6,6406079,6001252,404827,6.3
2002,Feb,67.7,63.4,6398245,5986048,412197,6.4
2002,Mar,67.6,63.2,6389001,5971273,417728,6.5
2002,Apr,67.5,63,6378638,5957701,420937,6.6
2002,May,67.3,62.9,6367557,5945768,421789,6.6
2002,Jun,67.2,62.7,6356257,5935687,420570,6.6
2002,Jul,67,62.6,6344278,5926355,417923,6.6
2002,Aug,66.9,62.5,6332078,5917303,414775,6.6
2002,Sep,66.7,62.3,6320656,5908153,412503,6.5
2002,Oct,66.5,62.2,6310176,5897923,412253,6.5
2002,Nov,66.4,62.1,6301525,5888140,413385,6.6
2002,Dec,66.3,61.9,6294161,5879860,414301,6.6
2003,Jan,66.2,61.9,6289479,5874230,415249,6.6
2003,Feb,66.2,61.8,6288923,5872405,416518,6.6
2003,Mar,66.2,61.8,6291947,5873406,418541,6.7
2003,Apr,66.3,61.8,6296745,5874101,422644,6.7
2003,May,66.3,61.8,6300774,5872002,428772,6.8
2003,Jun,66.3,61.7,6303462,5868213,435249,6.9
2003,Jul,66.2,61.6,6304691,5865120,439571,7
2003,Aug,66.2,61.6,6304389,5864487,439902,7
2003,Sep,66.2,61.6,6302881,5867671,435210,6.9
2003,Oct,66.1,61.6,6301623,5874607,427016,6.8
2003,Nov,66.1,61.7,6301537,5883474,418063,6.6
2003,Dec,66.1,61.8,6302761,5892125,410636,6.5
2004,Jan,66.1,61.8,6304014,5898884,405130,6.4
2004,Feb,66.1,61.9,6304636,5903488,401148,6.4
2004,Mar,66.1,61.9,6306165,5907621,398544,6.3
2004,Apr,66.1,61.9,6308393,5912566,395827,6.3
2004,May,66.1,62,6311094,5918546,392548,6.2
2004,Jun,66.1,62,6314871,5925329,389542,6.2
2004,Jul,66.1,62.1,6320495,5932774,387721,6.1
2004,Aug,66.2,62.1,6327663,5940901,386762,6.1
2004,Sep,66.2,62.2,6335450,5949067,386383,6.1
2004,Oct,66.2,62.2,6342646,5956622,386024,6.1
2004,Nov,66.3,62.3,6348510,5963704,384806,6.1
2004,Dec,66.3,62.3,6354427,5971205,383222,6
2005,Jan,66.4,62.4,6360665,5979321,381344,6
2005,Feb,66.4,62.4,6366666,5987352,379314,6
2005,Mar,66.4,62.5,6372136,5995822,376314,5.9
2005,Apr,66.5,62.6,6378227,6005800,372427,5.8
2005,May,66.5,62.7,6385844,6017800,368044,5.8
2005,Jun,66.6,62.8,6394147,6030415,363732,5.7
2005,Jul,66.6,62.9,6402445,6041549,360896,5.6
2005,Aug,66.7,62.9,6410083,6050646,359437,5.6
2005,Sep,66.7,63,6416563,6058871,357692,5.6
2005,Oct,66.6,63,6422142,6068506,353636,5.5
2005,Nov,66.7,63.1,6427836,6080747,347089,5.4
2005,Dec,66.7,63.2,6433912,6095642,338270,5.3
2006,Jan,66.7,63.3,6441382,6113695,327687,5.1
2006,Feb,66.8,63.5,6451005,6134401,316604,4.9
2006,Mar,66.9,63.7,6463362,6156184,307178,4.8
2006,Apr,67,63.9,6478443,6177693,300750,4.6
2006,May,67.2,64.1,6495465,6199195,296270,4.6
2006,Jun,67.4,64.3,6513369,6220837,292532,4.5
2006,Jul,67.5,64.5,6532199,6243665,288534,4.4
2006,Aug,67.7,64.7,6552460,6266985,285475,4.4
2006,Sep,67.9,64.9,6573252,6288064,285188,4.3
2006,Oct,68,65,6592252,6305158,287094,4.4
2006,Nov,68.1,65.1,6607145,6316919,290226,4.4
2006,Dec,68.2,65.1,6616283,6322363,293920,4.4
2007,Jan,68.2,65.1,6620604,6322280,298324,4.5
2007,Feb,68.2,65,6623049,6319804,303245,4.6
2007,Mar,68.1,65,6625194,6317542,307652,4.6
2007,Apr,68.1,64.9,6629361,6317789,311572,4.7
2007,May,68.2,64.9,6637831,6321339,316492,4.8
2007,Jun,68.3,65,6650894,6327742,323152,4.9
2007,Jul,68.4,65,6667148,6335700,331448,5
2007,Aug,68.5,65.1,6684622,6343732,340890,5.1
2007,Sep,68.7,65.1,6700912,6351056,349856,5.2
2007,Oct,68.8,65.1,6713641,6355963,357678,5.3
2007,Nov,68.8,65.1,6720994,6358249,362745,5.4
2007,Dec,68.8,65,6722716,6358186,364530,5.4
2008,Jan,68.7,65,6719466,6353880,365586,5.4
2008,Feb,68.6,64.8,6712103,6344116,367987,5.5
2008,Mar,68.5,64.6,6702655,6328876,373779,5.6
2008,Apr,68.3,64.4,6691978,6308469,383509,5.7
2008,May,68.2,64.1,6680143,6284189,395954,5.9
2008,Jun,68,63.8,6667190,6258121,409069,6.1
2008,Jul,67.8,63.5,6652581,6231413,421168,6.3
2008,Aug,67.6,63.2,6636562,6205083,431479,6.5
2008,Sep,67.4,62.9,6621432,6179097,442335,6.7
2008,Oct,67.2,62.6,6610157,6152180,457977,6.9
2008,Nov,67.1,62.2,6604189,6122512,481677,7.3
2008,Dec,67.1,61.9,6603955,6090230,513725,7.8
2009,Jan,67.1,61.5,6608305,6057455,550850,8.3
2009,Feb,67.2,61.2,6616877,6027328,589549,8.9
2009,Mar,67.2,60.9,6628347,6003114,625233,9.4
2009,Apr,67.3,60.7,6639249,5985380,653869,9.8
2009,May,67.3,60.5,6645470,5970489,674981,10.2
2009,Jun,67.3,60.3,6644812,5955214,689598,10.4
2009,Jul,67.2,60.1,6636459,5937036,699423,10.5
2009,Aug,67,59.8,6622400,5915107,707293,10.7
2009,Sep,66.8,59.6,6607886,5892295,715591,10.8
2009,Oct,66.7,59.3,6597946,5873134,724812,11
2009,Nov,66.6,59.2,6598227,5863022,735205,11.1
2009,Dec,66.7,59.2,6610271,5865244,745027,11.3
2010,Jan,66.9,59.3,6629263,5879062,750201,11.3
2010,Feb,67,59.5,6646430,5898678,747752,11.3
2010,Mar,67.1,59.7,6655359,5917703,737656,11.1
2010,Apr,67.3,60,6654739,5932888,721851,10.8
2010,May,67.2,60.1,6645625,5943454,702171,10.6
2010,Jun,67.1,60.1,6631747,5948816,682931,10.3
2010,Jul,66.9,60.1,6618603,5950375,668228,10.1
2010,Aug,66.8,60.1,6609418,5950971,658447,10
2010,Sep,66.6,60.1,6603128,5951512,651616,9.9
2010,Oct,66.6,60,6598069,5952925,645144,9.8
2010,Nov,66.5,60,6591482,5954456,637026,9.7
2010,Dec,66.3,60,6582389,5954441,627948,9.5
2011,Jan,66.2,60,6573539,5952822,620717,9.4
2011,Feb,66.1,59.9,6566762,5949580,617182,9.4
2011,Mar,66.1,59.8,6562927,5944798,618129,9.4
2011,Apr,66,59.8,6563289,5938760,624529,9.5
2011,May,66.1,59.7,6569329,5933281,636048,9.7
2011,Jun,66.1,59.6,6579893,5930717,649176,9.9
2011,Jul,66.2,59.6,6592480,5932875,659605,10
2011,Aug,66.3,59.7,6603943,5939511,664432,10.1
2011,Sep,66.4,59.7,6610989,5949295,661694,10
2011,Oct,66.3,59.8,6611838,5960203,651635,9.9
2011,Nov,66.3,59.9,6605805,5969807,635998,9.6
2011,Dec,66.1,59.9,6594308,5976406,617902,9.4
2012,Jan,66,59.9,6581090,5979812,601278,9.1
2012,Feb,65.9,59.9,6571177,5981308,589869,9
2012,Mar,65.8,59.9,6567040,5981313,585727,8.9
2012,Apr,65.8,59.9,6567372,5980357,587015,8.9
2012,May,65.8,59.9,6571517,5980993,590524,9
2012,Jun,65.8,59.9,6577714,5984744,592970,9
2012,Jul,65.9,60,6584040,5991553,592487,9
2012,Aug,65.9,60,6590143,5999586,590557,9
2012,Sep,65.9,60,6596052,6006010,590042,8.9
2012,Oct,66,60,6599251,6007289,591962,9
2012,Nov,65.9,60,6597998,6001762,596236,9
2012,Dec,65.8,59.8,6592027,5990669,601358,9.1
2013,Jan,65.7,59.7,6582499,5976602,605897,9.2
2013,Feb,65.6,59.5,6571939,5963501,608438,9.3
2013,Mar,65.5,59.4,6563015,5955200,607815,9.3
2013,Apr,65.5,59.4,6558406,5953676,604730,9.2
2013,May,65.4,59.4,6556908,5955695,601213,9.2
2013,Jun,65.4,59.4,6556074,5957303,598771,9.1
2013,Jul,65.3,59.4,6553792,5956577,597215,9.1
2013,Aug,65.3,59.4,6547571,5954206,593365,9.1
2013,Sep,65.2,59.3,6538493,5952790,585703,9
2013,Oct,65.1,59.3,6531285,5955019,576266,8.8
2013,Nov,65,59.4,6529007,5962789,566218,8.7
2013,Dec,65,59.5,6530529,5975241,555288,8.5
2014,Jan,65.1,59.7,6535431,5993052,542379,8.3
2014,Feb,65.1,59.8,6534756,6007828,526928,8.1
2014,Mar,65,59.9,6530889,6020562,510327,7.8
2014,Apr,64.9,60,6523322,6029722,493600,7.6
2014,May,64.8,60.1,6514281,6037402,476879,7.3
2014,Jun,64.8,60.2,6507901,6046821,461080,7.1
2014,Jul,64.7,60.3,6505054,6057874,447180,6.9
2014,Aug,64.7,60.4,6505576,6069687,435889,6.7
2014,Sep,64.7,60.5,6507158,6080707,426451,6.6
2014,Oct,64.7,60.6,6505589,6088861,416728,6.4
2014,Nov,64.6,60.6,6498925,6092601,406324,6.3
2014,Dec,64.5,60.6,6490580,6093224,397356,6.1
2015,Jan,64.4,60.5,6479540,6088283,391257,6
2015,Feb,64.4,60.6,6478614,6089834,388780,6
2015,Mar,64.5,60.6,6483485,6094889,388596,6
2015,Apr,64.6,60.7,6492377,6103447,388930,6
2015,May,64.7,60.8,6501191,6112982,388209,6
2015,Jun,64.7,60.9,6506555,6120533,386022,5.9
2015,Jul,64.7,60.9,6508842,6125365,383477,5.9
2015,Aug,64.8,61,6510127,6128163,381964,5.9
2015,Sep,64.8,61,6512908,6130997,381911,5.9
2015,Oct,64.9,61,6520952,6136825,384127,5.9
2015,Nov,65,61.1,6535516,6146369,389147,6
2015,Dec,65.2,61.3,6552831,6157544,395287,6
2016,Jan,65.3,61.4,6567794,6167588,400206,6.1
2016,Feb,65.4,61.4,6576715,6174341,402374,6.1
2016,Mar,65.5,61.5,6577603,6176953,400650,6.1
2016,Apr,65.4,61.5,6571787,6175766,396021,6
2016,May,65.3,61.4,6562522,6172165,390357,5.9
2016,Jun,65.2,61.4,6551737,6167321,384416,5.9
2016,Jul,65.1,61.3,6540568,6162291,378277,5.8
2016,Aug,65,61.3,6530343,6157339,373004,5.7
2016,Sep,64.9,61.2,6521502,6152224,369278,5.7
2016,Oct,64.8,61.2,6512450,6147124,365326,5.6
2016,Nov,64.7,61.1,6502562,6143598,358964,5.5
2016,Dec,64.6,61.1,6492891,6142661,350230,5.4
2017,Jan,64.5,61.2,6484711,6143987,340724,5.3
2017,Feb,64.5,61.2,6478255,6146694,331561,5.1
2017,Mar,64.5,61.2,6473705,6149056,324649,5
2017,Apr,64.4,61.3,6472076,6151235,320841,5
2017,May,64.5,61.3,6473346,6153887,319459,4.9
2017,Jun,64.5,61.3,6476716,6156853,319863,4.9
2017,Jul,64.6,61.4,6481304,6160307,320997,5
2017,Aug,64.6,61.4,6484128,6163798,320330,4.9
2017,Sep,64.6,61.4,6483625,6167026,316599,4.9
2017,Oct,64.6,61.5,6480390,6169955,310435,4.8
2017,Nov,64.5,61.5,6474985,6172027,302958,4.7
2017,Dec,64.5,61.5,6468743,6173887,294856,4.6
2018,Jan,64.4,61.6,6464113,6176211,287902,4.5
2018,Feb,64.5,61.6,6463085,6179396,283689,4.4
2018,Mar,64.5,61.7,6464625,6182845,281780,4.4
2018,Apr,64.5,61.7,6465232,6184640,280592,4.3
2018,May,64.5,61.7,6463579,6184058,279521,4.3
2018,Jun,64.5,61.7,6460591,6182634,277957,4.3
2018,Jul,64.5,61.7,6457531,6181715,275816,4.3
2018,Aug,64.5,61.7,6457071,6182617,274454,4.3
2018,Sep,64.5,61.8,6460176,6185692,274484,4.2
2018,Oct,64.6,61.8,6465769,6189695,276074,4.3
2018,Nov,64.6,61.8,6472201,6193166,279035,4.3
2018,Dec,64.7,61.9,6476504,6194343,282161,4.4
2019,Jan,64.7,61.9,6475751,6192440,283311,4.4
2019,Feb,64.6,61.8,6469321,6188045,281276,4.3
2019,Mar,64.6,61.8,6460202,6183400,276802,4.3
2019,Apr,64.5,61.8,6452156,6181182,270974,4.2
2019,May,64.5,61.8,6447045,6182433,264612,4.1
2019,Jun,64.5,61.9,6445179,6186736,258443,4
2019,Jul,64.5,61.9,6444841,6192675,252166,3.9
2019,Aug,64.4,62,6442858,6197008,245850,3.8
2019,Sep,64.4,62,6439731,6199414,240317,3.7
2019,Oct,64.4,62,6435480,6199272,236208,3.7
2019,Nov,64.4,62,6433159,6197576,235583,3.7
2019,Dec,64.4,62,6433027,6196809,236218,3.7
2020,Jan,64.2,61.9,6417226,6189437,227789,3.5
2020,Feb,64.1,61.9,6398665,6179880,218785,3.4
2020,Mar,63,60.4,6294250,6030123,264127,4.2
2020,Apr,61.3,50.8,6123362,5072987,1050375,17.2
2020,May,63.2,53.5,6305015,5337980,967035,15.3
2020,Jun,65.1,55.6,6493413,5549811,943602,14.5
2020,Jul,62.6,55.4,6248853,5533043,715810,11.5
2020,Aug,63.3,56.3,6316526,5621499,695027,11
2020,Sep,64.1,57.5,6392549,5740445,652104,10.2
