Year,Period,labor force participation rate,employment-population ratio,labor force,employment,unemployment,unemployment rate
1976,Jan,60.6,57.2,1489641,1406646,82995,5.6
1976,Feb,60.4,57,1489199,1406247,82952,5.6
1976,Mar,60.3,56.9,1488878,1406193,82685,5.6
1976,Apr,60.2,56.9,1489497,1407354,82143,5.5
1976,May,60.1,56.8,1490936,1409389,81547,5.5
1976,Jun,60.1,56.8,1492875,1411989,80886,5.4
1976,Jul,60,56.8,1494595,1414170,80425,5.4
1976,Aug,60,56.8,1495794,1416017,79777,5.3
1976,Sep,59.9,56.7,1496632,1417964,78668,5.3
1976,Oct,59.9,56.8,1498091,1420505,77586,5.2
1976,Nov,59.9,56.8,1501132,1424211,76921,5.1
1976,Dec,60,56.9,1506093,1429442,76651,5.1
1977,Jan,60.1,57.1,1512702,1436071,76631,5.1
1977,Feb,60.3,57.3,1519806,1443414,76392,5
1977,Mar,60.5,57.5,1525804,1450053,75751,5
1977,Apr,60.5,57.6,1529936,1455042,74894,4.9
1977,May,60.5,57.6,1532361,1458427,73934,4.8
1977,Jun,60.5,57.6,1533975,1461025,72950,4.8
1977,Jul,60.4,57.6,1535854,1463770,72084,4.7
1977,Aug,60.5,57.6,1539136,1467138,71998,4.7
1977,Sep,60.6,57.7,1543953,1471034,72919,4.7
1977,Oct,60.7,57.8,1549235,1474816,74419,4.8
1977,Nov,60.8,57.9,1554290,1478198,76092,4.9
1977,Dec,60.9,57.9,1558938,1481279,77659,5
1978,Jan,61,57.9,1563156,1484469,78687,5
1978,Feb,61.1,58,1567269,1488114,79155,5.1
1978,Mar,61.2,58.1,1571756,1492471,79285,5
1978,Apr,61.3,58.2,1576598,1497301,79297,5
1978,May,61.4,58.3,1581563,1501882,79681,5
1978,Jun,61.5,58.4,1585900,1505469,80431,5.1
1978,Jul,61.5,58.3,1589111,1507673,81438,5.1
1978,Aug,61.5,58.3,1591204,1508728,82476,5.2
1978,Sep,61.5,58.3,1592342,1509202,83140,5.2
1978,Oct,61.4,58.2,1593201,1509859,83342,5.2
1978,Nov,61.4,58.2,1594132,1510817,83315,5.2
1978,Dec,61.3,58.1,1594884,1511600,83284,5.2
1979,Jan,61.3,58.1,1595459,1512070,83389,5.2
1979,Feb,61.3,58,1596382,1512697,83685,5.2
1979,Mar,61.3,58,1598355,1514124,84231,5.3
1979,Apr,61.3,58.1,1601999,1516756,85243,5.3
1979,May,61.4,58.1,1607418,1520632,86786,5.4
1979,Jun,61.6,58.2,1613981,1525140,88841,5.5
1979,Jul,61.8,58.3,1620680,1529807,90873,5.6
1979,Aug,62,58.4,1626376,1534103,92273,5.7
1979,Sep,62.1,58.5,1630605,1537382,93223,5.7
1979,Oct,62.1,58.5,1633338,1539206,94132,5.8
1979,Nov,62.1,58.5,1634995,1539529,95466,5.8
1979,Dec,62.1,58.4,1636511,1538616,97895,6
1980,Jan,62.1,58.3,1638679,1536646,102033,6.2
1980,Feb,62.2,58.1,1641478,1533609,107869,6.6
1980,Mar,62.2,57.9,1644595,1529824,114771,7
1980,Apr,62.3,57.7,1647859,1526006,121853,7.4
1980,May,62.4,57.5,1651513,1522888,128625,7.8
1980,Jun,62.5,57.4,1656061,1521195,134866,8.1
1980,Jul,62.7,57.4,1661210,1521017,140193,8.4
1980,Aug,62.8,57.4,1666376,1522074,144302,8.7
1980,Sep,62.9,57.4,1671022,1524109,146913,8.8
1980,Oct,63,57.5,1674604,1526711,147893,8.8
1980,Nov,63.1,57.5,1676816,1529501,147315,8.8
1980,Dec,63,57.6,1677778,1532170,145608,8.7
1981,Jan,63,57.6,1677589,1534186,143403,8.5
1981,Feb,62.9,57.6,1676153,1535023,141130,8.4
1981,Mar,62.7,57.5,1673723,1534505,139218,8.3
1981,Apr,62.6,57.4,1670298,1532567,137731,8.2
1981,May,62.3,57.2,1665795,1529508,136287,8.2
1981,Jun,62.1,57.1,1661115,1525862,135253,8.1
1981,Jul,62,56.9,1657847,1521900,135947,8.2
1981,Aug,61.9,56.7,1656657,1517798,138859,8.4
1981,Sep,61.8,56.5,1657389,1513783,143606,8.7
1981,Oct,61.9,56.3,1659397,1509940,149457,9
1981,Nov,61.9,56.1,1661849,1506271,155578,9.4
1981,Dec,62,56,1664396,1503220,161176,9.7
1982,Jan,62,55.9,1666953,1501355,165598,9.9
1982,Feb,62.1,55.8,1669907,1500761,169146,10.1
1982,Mar,62.2,55.8,1673196,1501087,172109,10.3
1982,Apr,62.3,55.8,1676683,1501903,174780,10.4
1982,May,62.4,55.8,1680223,1502774,177449,10.6
1982,Jun,62.4,55.8,1683084,1503236,179848,10.7
1982,Jul,62.5,55.7,1685109,1503203,181906,10.8
1982,Aug,62.5,55.7,1687194,1502746,184448,10.9
1982,Sep,62.5,55.6,1690034,1501885,188149,11.1
1982,Oct,62.6,55.5,1693789,1500814,192975,11.4
1982,Nov,62.7,55.4,1697734,1499712,198022,11.7
1982,Dec,62.8,55.3,1700192,1498297,201895,11.9
1983,Jan,62.8,55.2,1700816,1496580,204236,12
1983,Feb,62.7,55.1,1700021,1495184,204837,12
1983,Mar,62.6,55,1698523,1494459,204064,12
1983,Apr,62.5,55,1697668,1494858,202810,11.9
1983,May,62.5,55,1698288,1496714,201574,11.9
1983,Jun,62.5,55.1,1700404,1500098,200306,11.8
1983,Jul,62.5,55.3,1703144,1504875,198269,11.6
1983,Aug,62.6,55.5,1705360,1510520,194840,11.4
1983,Sep,62.6,55.7,1706376,1516539,189837,11.1
1983,Oct,62.6,55.9,1706109,1522525,183584,10.8
1983,Nov,62.6,56.1,1705424,1528108,177316,10.4
1983,Dec,62.6,56.2,1705624,1533194,172430,10.1
1984,Jan,62.6,56.4,1706834,1537796,169038,9.9
1984,Feb,62.6,56.5,1708852,1541953,166899,9.8
1984,Mar,62.7,56.7,1711450,1545631,165819,9.7
1984,Apr,62.8,56.7,1713388,1548410,164978,9.6
1984,May,62.8,56.8,1713779,1549983,163796,9.6
1984,Jun,62.7,56.8,1712200,1550354,161846,9.5
1984,Jul,62.6,56.7,1708606,1549678,158928,9.3
1984,Aug,62.4,56.7,1703653,1548378,155275,9.1
1984,Sep,62.1,56.6,1698468,1546788,151680,8.9
1984,Oct,62,56.5,1694353,1545524,148829,8.8
1984,Nov,61.8,56.5,1692044,1545182,146862,8.7
1984,Dec,61.8,56.5,1691594,1545723,145871,8.6
1985,Jan,61.8,56.5,1692480,1546407,146073,8.6
1985,Feb,61.8,56.4,1693680,1546269,147411,8.7
1985,Mar,61.8,56.4,1694097,1544840,149257,8.8
1985,Apr,61.8,56.3,1693685,1542400,151285,8.9
1985,May,61.7,56.1,1692887,1539483,153404,9.1
1985,Jun,61.7,56,1692299,1536750,155549,9.2
1985,Jul,61.6,55.9,1692579,1534700,157879,9.3
1985,Aug,61.7,55.8,1693655,1533653,160002,9.4
1985,Sep,61.7,55.8,1694989,1533437,161552,9.5
1985,Oct,61.7,55.8,1696007,1533343,162664,9.6
1985,Nov,61.7,55.7,1696311,1532800,163511,9.6
1985,Dec,61.6,55.7,1695667,1531740,163927,9.7
1986,Jan,61.5,55.6,1694300,1530581,163719,9.7
1986,Feb,61.4,55.5,1692826,1530010,162816,9.6
1986,Mar,61.4,55.5,1691680,1530443,161237,9.5
1986,Apr,61.3,55.6,1691021,1531815,159206,9.4
1986,May,61.3,55.6,1690864,1533703,157161,9.3
1986,Jun,61.3,55.6,1691417,1535581,155836,9.2
1986,Jul,61.3,55.7,1692518,1536947,155571,9.2
1986,Aug,61.3,55.7,1693921,1537520,156401,9.2
1986,Sep,61.4,55.6,1695384,1537446,157938,9.3
1986,Oct,61.4,55.6,1696525,1537114,159411,9.4
1986,Nov,61.4,55.6,1697044,1536758,160286,9.4
1986,Dec,61.3,55.5,1697192,1536955,160237,9.4
1987,Jan,61.3,55.6,1697184,1538007,159177,9.4
1987,Feb,61.3,55.6,1696788,1539760,157028,9.3
1987,Mar,61.2,55.7,1696041,1542036,154005,9.1
1987,Apr,61.1,55.7,1694711,1544420,150291,8.9
1987,May,61,55.8,1692667,1546565,146102,8.6
1987,Jun,60.9,55.8,1690261,1548318,141943,8.4
1987,Jul,60.8,55.9,1688204,1549859,138345,8.2
1987,Aug,60.8,55.9,1687168,1551422,135746,8
1987,Sep,60.7,55.9,1687564,1553321,134243,8
1987,Oct,60.8,56,1689352,1555502,133850,7.9
1987,Nov,60.9,56,1692101,1557947,134154,7.9
1987,Dec,61,56.1,1695094,1560402,134692,7.9
1988,Jan,61,56.2,1697572,1562699,134873,7.9
1988,Feb,61,56.2,1699496,1564977,134519,7.9
1988,Mar,61.1,56.3,1701192,1567320,133872,7.9
1988,Apr,61.1,56.4,1703342,1570154,133188,7.8
1988,May,61.2,56.4,1706404,1573799,132605,7.8
1988,Jun,61.3,56.6,1710187,1578180,132007,7.7
1988,Jul,61.4,56.7,1714294,1582980,131314,7.7
1988,Aug,61.6,56.9,1718259,1587906,130353,7.6
1988,Sep,61.7,57.1,1721656,1592798,128858,7.5
1988,Oct,61.8,57.2,1724133,1597641,126492,7.3
1988,Nov,61.8,57.4,1725731,1602351,123380,7.1
1988,Dec,61.8,57.5,1726576,1606568,120008,7
1989,Jan,61.8,57.7,1727199,1610284,116915,6.8
1989,Feb,61.9,57.7,1728158,1613504,114654,6.6
1989,Mar,61.9,57.8,1729654,1616469,113185,6.5
1989,Apr,62,57.9,1731704,1619195,112509,6.5
1989,May,62,58,1734003,1621653,112350,6.5
1989,Jun,62.1,58.1,1736253,1624110,112143,6.5
1989,Jul,62.1,58.2,1738079,1626633,111446,6.4
1989,Aug,62.2,58.2,1739490,1629305,110185,6.3
1989,Sep,62.2,58.3,1740746,1632219,108527,6.2
1989,Oct,62.2,58.4,1742277,1635780,106497,6.1
1989,Nov,62.3,58.6,1744219,1639910,104309,6
1989,Dec,62.4,58.7,1746569,1644234,102335,5.9
1990,Jan,63.1,59.4,1749107,1648168,100939,5.8
1990,Feb,63,59.4,1751226,1651095,100131,5.7
1990,Mar,63,59.4,1752597,1652741,99856,5.7
1990,Apr,62.9,59.3,1753152,1653222,99930,5.7
1990,May,62.7,59.1,1753188,1653021,100167,5.7
1990,Jun,62.6,59,1753143,1652330,100813,5.8
1990,Jul,62.5,58.9,1753542,1651489,102053,5.8
1990,Aug,62.5,58.8,1754329,1650494,103835,5.9
1990,Sep,62.5,58.7,1755083,1648833,106250,6.1
1990,Oct,62.4,58.5,1755801,1646029,109772,6.3
1990,Nov,62.4,58.4,1756711,1642468,114243,6.5
1990,Dec,62.4,58.2,1757989,1638976,119013,6.8
1991,Jan,62.4,58.1,1759529,1635989,123540,7
1991,Feb,62.5,58,1761238,1633971,127267,7.2
1991,Mar,62.5,57.9,1762717,1632873,129844,7.4
1991,Apr,62.5,57.9,1763658,1632490,131168,7.4
1991,May,62.5,57.8,1764062,1632601,131461,7.5
1991,Jun,62.4,57.8,1763963,1633025,130938,7.4
1991,Jul,62.4,57.8,1763449,1633530,129919,7.4
1991,Aug,62.3,57.7,1763065,1634078,128987,7.3
1991,Sep,62.2,57.7,1763341,1634907,128434,7.3
1991,Oct,62.2,57.7,1763984,1635962,128022,7.3
1991,Nov,62.2,57.7,1764513,1637211,127302,7.2
1991,Dec,62.1,57.7,1764621,1638671,125950,7.1
1992,Jan,62.1,57.7,1764695,1640598,124097,7
1992,Feb,62.1,57.8,1765410,1643121,122289,6.9
1992,Mar,62.1,57.8,1767302,1646303,120999,6.8
1992,Apr,62.2,57.9,1770471,1649934,120537,6.8
1992,May,62.2,58,1774370,1653470,120900,6.8
1992,Jun,62.3,58.1,1778336,1656501,121835,6.9
1992,Jul,62.4,58.1,1781915,1658893,123022,6.9
1992,Aug,62.4,58.1,1784828,1660872,123956,6.9
1992,Sep,62.4,58.1,1786849,1662876,123973,6.9
1992,Oct,62.4,58.1,1788413,1665449,122964,6.9
1992,Nov,62.4,58.1,1790109,1668530,121579,6.8
1992,Dec,62.3,58.2,1792379,1671866,120513,6.7
1993,Jan,62.4,58.2,1795352,1675331,120021,6.7
1993,Feb,62.4,58.3,1798708,1678761,119947,6.7
1993,Mar,62.5,58.3,1802160,1682150,120010,6.7
1993,Apr,62.5,58.4,1805191,1685456,119735,6.6
1993,May,62.5,58.4,1807222,1688466,118756,6.6
1993,Jun,62.5,58.4,1807977,1691144,116833,6.5
1993,Jul,62.4,58.5,1807273,1693494,113779,6.3
1993,Aug,62.3,58.5,1805398,1695505,109893,6.1
1993,Sep,62.1,58.5,1803515,1697326,106189,5.9
1993,Oct,62,58.5,1802674,1699200,103474,5.7
1993,Nov,62,58.5,1803232,1701303,101929,5.7
1993,Dec,62,58.5,1805187,1703912,101275,5.6
1994,Jan,62.1,58.6,1807949,1707026,100923,5.6
1994,Feb,62.2,58.7,1810792,1710289,100503,5.6
1994,Mar,62.2,58.8,1813285,1713372,99913,5.5
1994,Apr,62.2,58.8,1815505,1716379,99126,5.5
1994,May,62.3,58.9,1818062,1719716,98346,5.4
1994,Jun,62.3,59,1821308,1723548,97760,5.4
1994,Jul,62.4,59.1,1825509,1727955,97554,5.3
1994,Aug,62.5,59.2,1830539,1732925,97614,5.3
1994,Sep,62.6,59.3,1835729,1738196,97533,5.3
1994,Oct,62.7,59.4,1840312,1743432,96880,5.3
1994,Nov,62.8,59.5,1844201,1748410,95791,5.2
1994,Dec,62.9,59.6,1847324,1752462,94862,5.1
1995,Jan,62.9,59.7,1849725,1755082,94643,5.1
1995,Feb,62.9,59.7,1851694,1756438,95256,5.1
1995,Mar,62.9,59.6,1853467,1756795,96672,5.2
1995,Apr,62.9,59.6,1855213,1756411,98802,5.3
1995,May,62.9,59.5,1856981,1755776,101205,5.4
1995,Jun,62.9,59.4,1858667,1755323,103344,5.6
1995,Jul,62.9,59.3,1859800,1755169,104631,5.6
1995,Aug,62.8,59.3,1859790,1755018,104772,5.6
1995,Sep,62.7,59.2,1858686,1754667,104019,5.6
1995,Oct,62.6,59.1,1856883,1754054,102829,5.5
1995,Nov,62.5,59,1854845,1753225,101620,5.5
1995,Dec,62.4,59,1853287,1752568,100719,5.4
1996,Jan,62.3,58.9,1852859,1752646,100213,5.4
1996,Feb,62.3,58.9,1853877,1753804,100073,5.4
1996,Mar,62.3,59,1856155,1756270,99885,5.4
1996,Apr,62.4,59,1858990,1759887,99103,5.3
1996,May,62.4,59.1,1862132,1764339,97793,5.3
1996,Jun,62.5,59.3,1866020,1769309,96711,5.2
1996,Jul,62.6,59.4,1871289,1774438,96851,5.2
1996,Aug,62.8,59.5,1878184,1779373,98811,5.3
1996,Sep,63,59.6,1885952,1783573,102379,5.4
1996,Oct,63.2,59.7,1893663,1786700,106963,5.6
1996,Nov,63.4,59.7,1900404,1789059,111345,5.9
1996,Dec,63.6,59.8,1905380,1791235,114145,6
1997,Jan,63.7,59.8,1908443,1793715,114728,6
1997,Feb,63.7,59.9,1910034,1796903,113131,5.9
1997,Mar,63.7,60,1911130,1801001,110129,5.8
1997,Apr,63.8,60.2,1912940,1805827,107113,5.6
1997,May,63.8,60.3,1915531,1810720,104811,5.5
1997,Jun,63.9,60.5,1918248,1815100,103148,5.4
1997,Jul,63.9,60.6,1920531,1818831,101700,5.3
1997,Aug,63.9,60.6,1921979,1821984,99995,5.2
1997,Sep,63.9,60.6,1922301,1824738,97563,5.1
1997,Oct,63.8,60.6,1921677,1827202,94475,4.9
1997,Nov,63.7,60.6,1920600,1829343,91257,4.8
1997,Dec,63.6,60.7,1919844,1831325,88519,4.6
1998,Jan,63.5,60.7,1919946,1833157,86789,4.5
1998,Feb,63.6,60.7,1921119,1834817,86302,4.5
1998,Mar,63.6,60.7,1923155,1836324,86831,4.5
1998,Apr,63.6,60.7,1925845,1837990,87855,4.6
1998,May,63.6,60.7,1929011,1840023,88988,4.6
1998,Jun,63.7,60.7,1932242,1842321,89921,4.7
1998,Jul,63.7,60.8,1935087,1844721,90366,4.7
1998,Aug,63.8,60.8,1937596,1847256,90340,4.7
1998,Sep,63.8,60.8,1940101,1849938,90163,4.6
1998,Oct,63.8,60.9,1942517,1852655,89862,4.6
1998,Nov,63.8,60.9,1944673,1855134,89539,4.6
1998,Dec,63.9,60.9,1946735,1857263,89472,4.6
1999,Jan,63.9,61,1948949,1859271,89678,4.6
1999,Feb,63.9,61,1951444,1861358,90086,4.6
1999,Mar,64,61,1954109,1863576,90533,4.6
1999,Apr,64,61.1,1956644,1865840,90804,4.6
1999,May,64,61.1,1958910,1868052,90858,4.6
1999,Jun,64.1,61.1,1960870,1870242,90628,4.6
1999,Jul,64.1,61.1,1962334,1872295,90039,4.6
1999,Aug,64,61.1,1963082,1874204,88878,4.5
1999,Sep,64,61.2,1963426,1876142,87284,4.4
1999,Oct,64,61.2,1964013,1878302,85711,4.4
1999,Nov,64,61.2,1965183,1880944,84239,4.3
1999,Dec,64,61.3,1966691,1883766,82925,4.2
2000,Jan,64,61.3,1968042,1886193,81849,4.2
2000,Feb,64,61.3,1968722,1887688,81034,4.1
2000,Mar,63.9,61.3,1968494,1887922,80572,4.1
2000,Apr,63.9,61.3,1967218,1886889,80329,4.1
2000,May,63.7,61.2,1965116,1885008,80108,4.1
2000,Jun,63.6,61,1962889,1882814,80075,4.1
2000,Jul,63.5,60.9,1961421,1880996,80425,4.1
2000,Aug,63.5,60.9,1961456,1880200,81256,4.1
2000,Sep,63.5,60.8,1962928,1880568,82360,4.2
2000,Oct,63.5,60.8,1965207,1881728,83479,4.2
2000,Nov,63.6,60.8,1967701,1882745,84956,4.3
2000,Dec,63.6,60.8,1969532,1882681,86851,4.4
2001,Jan,63.6,60.7,1969813,1880974,88839,4.5
2001,Feb,63.5,60.6,1968375,1877674,90701,4.6
2001,Mar,63.4,60.4,1965609,1873209,92400,4.7
2001,Apr,63.3,60.2,1962099,1868079,94020,4.8
2001,May,63.1,60,1958708,1862931,95777,4.9
2001,Jun,63,59.8,1956033,1858118,97915,5
2001,Jul,62.9,59.7,1954436,1853776,100660,5.2
2001,Aug,62.8,59.5,1953685,1849532,104153,5.3
2001,Sep,62.8,59.3,1953373,1845338,108035,5.5
2001,Oct,62.7,59.2,1953155,1841556,111599,5.7
2001,Nov,62.7,59,1952403,1838430,113973,5.8
2001,Dec,62.6,58.9,1951076,1836252,114824,5.9
2002,Jan,62.5,58.8,1949415,1835019,114396,5.9
2002,Feb,62.4,58.8,1947340,1834376,112964,5.8
2002,Mar,62.3,58.8,1944942,1833963,110979,5.7
2002,Apr,62.2,58.7,1942987,1833794,109193,5.6
2002,May,62.1,58.7,1941933,1833835,108098,5.6
2002,Jun,62.1,58.7,1941692,1834055,107637,5.5
2002,Jul,62.1,58.6,1941963,1834187,107776,5.5
2002,Aug,62,58.6,1942520,1834107,108413,5.6
2002,Sep,62,58.5,1943301,1833682,109619,5.6
2002,Oct,62,58.4,1944067,1832774,111293,5.7
2002,Nov,61.9,58.3,1944935,1831821,113114,5.8
2002,Dec,61.9,58.3,1946050,1831222,114828,5.9
2003,Jan,61.9,58.2,1947893,1831348,116545,6
2003,Feb,62,58.2,1950900,1832389,118511,6.1
2003,Mar,62.1,58.3,1954614,1834084,120530,6.2
2003,Apr,62.2,58.3,1958146,1835880,122266,6.2
2003,May,62.2,58.3,1960829,1837287,123542,6.3
2003,Jun,62.2,58.3,1962696,1838406,124290,6.3
2003,Jul,62.2,58.2,1963845,1839598,124247,6.3
2003,Aug,62.2,58.3,1964326,1841115,123211,6.3
2003,Sep,62.1,58.3,1964224,1843047,121177,6.2
2003,Oct,62.1,58.3,1963845,1845250,118595,6
2003,Nov,62,58.4,1963497,1847383,116114,5.9
2003,Dec,62,58.4,1963181,1849124,114057,5.8
2004,Jan,62,58.4,1962620,1850209,112411,5.7
2004,Feb,61.9,58.4,1961822,1850734,111088,5.7
2004,Mar,61.9,58.4,1961388,1851217,110171,5.6
2004,Apr,61.9,58.4,1961428,1852045,109383,5.6
2004,May,61.8,58.4,1961756,1853412,108344,5.5
2004,Jun,61.8,58.5,1962208,1855351,106857,5.4
2004,Jul,61.8,58.5,1962668,1857724,104944,5.3
2004,Aug,61.8,58.5,1963277,1860226,103051,5.2
2004,Sep,61.8,58.6,1964337,1862552,101785,5.2
2004,Oct,61.7,58.6,1966031,1864450,101581,5.2
2004,Nov,61.8,58.6,1968432,1865896,102536,5.2
2004,Dec,61.8,58.6,1971876,1867232,104644,5.3
2005,Jan,61.9,58.6,1976456,1868883,107573,5.4
2005,Feb,62.1,58.6,1981735,1870966,110769,5.6
2005,Mar,62.2,58.6,1987202,1873517,113685,5.7
2005,Apr,62.3,58.7,1992476,1876581,115895,5.8
2005,May,62.4,58.7,1997275,1880054,117221,5.9
2005,Jun,62.5,58.8,2001391,1883373,118018,5.9
2005,Jul,62.5,58.8,2004820,1885865,118955,5.9
2005,Aug,62.5,58.8,2007504,1887362,120142,6
2005,Sep,62.5,58.7,2009458,1888154,121304,6
2005,Oct,62.5,58.7,2011013,1888954,122059,6.1
2005,Nov,62.4,58.6,2012576,1890365,122211,6.1
2005,Dec,62.4,58.7,2014172,1892537,121635,6
2006,Jan,62.4,58.7,2015812,1895547,120265,6
2006,Feb,62.4,58.7,2017547,1899105,118442,5.9
2006,Mar,62.4,58.8,2019369,1902674,116695,5.8
2006,Apr,62.4,58.8,2021371,1905725,115646,5.7
2006,May,62.4,58.9,2023695,1908254,115441,5.7
2006,Jun,62.4,58.9,2026319,1910522,115797,5.7
2006,Jul,62.5,58.9,2029416,1913224,116192,5.7
2006,Aug,62.5,59,2033118,1916771,116347,5.7
2006,Sep,62.6,59,2037117,1920808,116309,5.7
2006,Oct,62.7,59.1,2040836,1924848,115988,5.7
2006,Nov,62.7,59.2,2043582,1928239,115343,5.6
2006,Dec,62.7,59.2,2044729,1930370,114359,5.6
2007,Jan,62.7,59.2,2044139,1931023,113116,5.5
2007,Feb,62.6,59.2,2042206,1930560,111646,5.5
2007,Mar,62.4,59.1,2039196,1929252,109944,5.4
2007,Apr,62.3,59,2035657,1927427,108230,5.3
2007,May,62.2,58.9,2032323,1925315,107008,5.3
2007,Jun,62,58.8,2029699,1923161,106538,5.2
2007,Jul,61.9,58.7,2028128,1921047,107081,5.3
2007,Aug,61.9,58.6,2027579,1919028,108551,5.4
2007,Sep,61.8,58.4,2027424,1917525,109899,5.4
2007,Oct,61.7,58.4,2026901,1916495,110406,5.4
2007,Nov,61.6,58.3,2025661,1915689,109972,5.4
2007,Dec,61.5,58.2,2023900,1914943,108957,5.4
2008,Jan,61.4,58.1,2022032,1913789,108243,5.4
2008,Feb,61.3,58,2020699,1912117,108582,5.4
2008,Mar,61.3,57.9,2020883,1910326,110557,5.5
2008,Apr,61.3,57.8,2023004,1908624,114380,5.7
2008,May,61.3,57.7,2026564,1906977,119587,5.9
2008,Jun,61.4,57.6,2030531,1905282,125249,6.2
2008,Jul,61.4,57.5,2033724,1903220,130504,6.4
2008,Aug,61.5,57.4,2035826,1900324,135502,6.7
2008,Sep,61.5,57.2,2037443,1896010,141433,6.9
2008,Oct,61.5,57,2039396,1890098,149298,7.3
2008,Nov,61.5,56.7,2042162,1882841,159321,7.8
2008,Dec,61.6,56.5,2045962,1874818,171144,8.4
2009,Jan,61.8,56.2,2050657,1866731,183926,9
2009,Feb,61.9,56,2055859,1859463,196396,9.6
2009,Mar,62,55.8,2061013,1853912,207101,10
2009,Apr,62.1,55.7,2065253,1850488,214765,10.4
2009,May,62.2,55.6,2067837,1848635,219202,10.6
2009,Jun,62.2,55.5,2068623,1847534,221089,10.7
2009,Jul,62.1,55.5,2067526,1846402,221124,10.7
2009,Aug,62,55.4,2064524,1844716,219808,10.6
2009,Sep,61.8,55.3,2060561,1842410,218151,10.6
2009,Oct,61.6,55.1,2056626,1839559,217067,10.6
2009,Nov,61.5,55,2053847,1836898,216949,10.6
2009,Dec,61.5,54.9,2052984,1835339,217645,10.6
2010,Jan,61.4,54.9,2053600,1835448,218152,10.6
2010,Feb,61.4,54.9,2054417,1836904,217513,10.6
2010,Mar,61.4,54.9,2054433,1839003,215430,10.5
2010,Apr,61.5,55.1,2053563,1841330,212233,10.3
2010,May,61.4,55.1,2052134,1843647,208487,10.2
2010,Jun,61.3,55.1,2050773,1845449,205324,10
2010,Jul,61.2,55.1,2050339,1846533,203806,9.9
2010,Aug,61.2,55.1,2051438,1847365,204073,9.9
2010,Sep,61.2,55.1,2053705,1848429,205276,10
2010,Oct,61.3,55.1,2056574,1850281,206293,10
2010,Nov,61.3,55.2,2059204,1852855,206349,10
2010,Dec,61.3,55.2,2060696,1855585,205111,10
2011,Jan,61.3,55.3,2060919,1858039,202880,9.8
2011,Feb,61.3,55.3,2059995,1859617,200378,9.7
2011,Mar,61.2,55.3,2058006,1859950,198056,9.6
2011,Apr,61.1,55.2,2055557,1859186,196371,9.6
2011,May,61,55.2,2053682,1858070,195612,9.5
2011,Jun,60.9,55.1,2052956,1857634,195322,9.5
2011,Jul,60.9,55.1,2053577,1858686,194891,9.5
2011,Aug,60.9,55.2,2055093,1861265,193828,9.4
2011,Sep,60.9,55.3,2056518,1864979,191539,9.3
2011,Oct,60.9,55.4,2057166,1869247,187919,9.1
2011,Nov,60.9,55.5,2056412,1873315,183097,8.9
2011,Dec,60.8,55.5,2054227,1876666,177561,8.6
2012,Jan,60.7,55.6,2051531,1879304,172227,8.4
2012,Feb,60.6,55.6,2049670,1881633,168037,8.2
2012,Mar,60.6,55.7,2049449,1883676,165773,8.1
2012,Apr,60.6,55.7,2050796,1885257,165539,8.1
2012,May,60.7,55.7,2053571,1886909,166662,8.1
2012,Jun,60.8,55.8,2057239,1889104,168135,8.2
2012,Jul,60.8,55.8,2061007,1891934,169073,8.2
2012,Aug,60.9,55.9,2064542,1895210,169332,8.2
2012,Sep,60.9,56,2067604,1898510,169094,8.2
2012,Oct,61,56,2069503,1901055,168448,8.1
2012,Nov,60.9,56,2070146,1902389,167757,8.1
2012,Dec,60.9,56,2069797,1902547,167250,8.1
2013,Jan,60.8,55.9,2068663,1901562,167101,8.1
2013,Feb,60.8,55.8,2067151,1899823,167328,8.1
2013,Mar,60.7,55.8,2065749,1898143,167606,8.1
2013,Apr,60.6,55.7,2064835,1897226,167609,8.1
2013,May,60.6,55.7,2063856,1896406,167450,8.1
2013,Jun,60.5,55.6,2062221,1894931,167290,8.1
2013,Jul,60.4,55.5,2059502,1892618,166884,8.1
2013,Aug,60.2,55.4,2055073,1889503,165570,8.1
2013,Sep,60,55.2,2049298,1885919,163379,8
2013,Oct,59.8,55.1,2043395,1882493,160902,7.9
2013,Nov,59.6,55,2038240,1879846,158394,7.8
2013,Dec,59.5,54.9,2034037,1878144,155893,7.7
2014,Jan,59.5,55,2032998,1879860,153138,7.5
2014,Feb,59.3,55,2029474,1879662,149812,7.4
2014,Mar,59.2,54.9,2025290,1879379,145911,7.2
2014,Apr,59,54.9,2019835,1878378,141457,7
2014,May,58.8,54.8,2013293,1876977,136316,6.8
2014,Jun,58.6,54.8,2006638,1875888,130750,6.5
2014,Jul,58.4,54.7,2000517,1875130,125387,6.3
2014,Aug,58.2,54.7,1995672,1874877,120795,6.1
2014,Sep,58.1,54.7,1992168,1875166,117002,5.9
2014,Oct,58,54.7,1989425,1875702,113723,5.7
2014,Nov,57.9,54.7,1986947,1876002,110945,5.6
2014,Dec,57.8,54.6,1984783,1875956,108827,5.5
2015,Jan,57.8,54.6,1984321,1876851,107470,5.4
2015,Feb,57.7,54.6,1982924,1876338,106586,5.4
2015,Mar,57.7,54.6,1981815,1875794,106021,5.3
2015,Apr,57.6,54.6,1980734,1875318,105416,5.3
2015,May,57.6,54.5,1979359,1874740,104619,5.3
2015,Jun,57.5,54.5,1977617,1873955,103662,5.2
2015,Jul,57.4,54.4,1976275,1873403,102872,5.2
2015,Aug,57.4,54.4,1976141,1873529,102612,5.2
2015,Sep,57.4,54.4,1977742,1874780,102962,5.2
2015,Oct,57.5,54.5,1981380,1877563,103817,5.2
2015,Nov,57.6,54.6,1986433,1881634,104799,5.3
2015,Dec,57.7,54.7,1991683,1886244,105439,5.3
2016,Jan,57.8,54.8,1996063,1890603,105460,5.3
2016,Feb,57.9,54.9,1999099,1894362,104737,5.2
2016,Mar,57.9,55,2001105,1897720,103385,5.2
2016,Apr,58,55,2003121,1901107,102014,5.1
2016,May,58,55.1,2006195,1904989,101206,5
2016,Jun,58.2,55.2,2010546,1909451,101095,5
2016,Jul,58.3,55.3,2015731,1914274,101457,5
2016,Aug,58.4,55.4,2021173,1918965,102208,5.1
2016,Sep,58.5,55.5,2026369,1923054,103315,5.1
2016,Oct,58.6,55.6,2030929,1926438,104491,5.1
2016,Nov,58.7,55.7,2035072,1929618,105454,5.2
2016,Dec,58.8,55.8,2039044,1933014,106030,5.2
2017,Jan,58.9,55.9,2042918,1936729,106189,5.2
2017,Feb,59,56,2046620,1940603,106017,5.2
2017,Mar,59.1,56,2049770,1944029,105741,5.2
2017,Apr,59.1,56.1,2052310,1947010,105300,5.1
2017,May,59.2,56.2,2054272,1949791,104481,5.1
2017,Jun,59.2,56.2,2055675,1952394,103281,5
2017,Jul,59.2,56.3,2056677,1954955,101722,4.9
2017,Aug,59.2,56.3,2056964,1957375,99589,4.8
2017,Sep,59.1,56.4,2056448,1959496,96952,4.7
2017,Oct,59.1,56.4,2055337,1961150,94187,4.6
2017,Nov,59,56.4,2053900,1962173,91727,4.5
2017,Dec,59,56.4,2052740,1962812,89928,4.4
2018,Jan,59,56.4,2052556,1963545,89011,4.3
2018,Feb,59,56.5,2053707,1964826,88881,4.3
2018,Mar,59.1,56.5,2055810,1966703,89107,4.3
2018,Apr,59.1,56.5,2057822,1968419,89403,4.3
2018,May,59.1,56.6,2058987,1969243,89744,4.4
2018,Jun,59.1,56.5,2059249,1969330,89919,4.4
2018,Jul,59.1,56.5,2058845,1969006,89839,4.4
2018,Aug,59.1,56.5,2058438,1968800,89638,4.4
2018,Sep,59,56.5,2058455,1969164,89291,4.3
2018,Oct,59,56.5,2058983,1970167,88816,4.3
2018,Nov,59,56.5,2059935,1971621,88314,4.3
2018,Dec,59.1,56.5,2060868,1973067,87801,4.3
2019,Jan,59.1,56.6,2061457,1974101,87356,4.2
2019,Feb,59.1,56.6,2061672,1974520,87152,4.2
2019,Mar,59.1,56.6,2062224,1974793,87431,4.2
2019,Apr,59.1,56.6,2063803,1975754,88049,4.3
2019,May,59.2,56.6,2066550,1977916,88634,4.3
2019,Jun,59.3,56.7,2070301,1981147,89154,4.3
2019,Jul,59.4,56.8,2074764,1985146,89618,4.3
2019,Aug,59.5,56.9,2078630,1988713,89917,4.3
2019,Sep,59.5,57,2081590,1991454,90136,4.3
2019,Oct,59.6,57,2083132,1992837,90295,4.3
2019,Nov,59.5,57,2082697,1992397,90300,4.3
2019,Dec,59.5,56.9,2082207,1991923,90284,4.3
2020,Jan,59.6,57,2084752,1994520,90232,4.3
2020,Feb,59.6,57,2084089,1995951,88138,4.2
2020,Mar,59,56,2066275,1958322,107953,5.2
2020,Apr,58.6,48.9,2052263,1712526,339737,16.6
2020,May,58,51.7,2029333,1809019,220314,10.9
2020,Jun,54.8,52.4,1920657,1836096,84561,4.4
2020,Jul,52.5,50.1,1837401,1755265,82136,4.5
2020,Aug,57.3,53,2008842,1858852,149990,7.5
2020,Sep,54.9,51.8,1925252,1817329,107923,5.6
