Year,Period,labor force participation rate,employment-population ratio,labor force,employment,unemployment,unemployment rate
1976,Jan,62.3,56.8,475639,433990,41649,8.8
1976,Feb,62.1,56.6,475595,433930,41665,8.8
1976,Mar,62,56.6,475697,434134,41563,8.7
1976,Apr,61.9,56.5,476036,434823,41213,8.7
1976,May,61.8,56.5,476408,435607,40801,8.6
1976,Jun,61.8,56.5,476771,436293,40478,8.5
1976,Jul,61.6,56.4,477028,436637,40391,8.5
1976,Aug,61.6,56.4,477300,436719,40581,8.5
1976,Sep,61.5,56.2,477675,436709,40966,8.6
1976,Oct,61.5,56.1,478254,436721,41533,8.7
1976,Nov,61.4,56,479045,436837,42208,8.8
1976,Dec,61.4,56,479906,437133,42773,8.9
1977,Jan,61.5,56,480715,437681,43034,9
1977,Feb,61.4,55.9,481378,438409,42969,8.9
1977,Mar,61.4,55.9,481778,439138,42640,8.9
1977,Apr,61.2,55.9,481844,439764,42080,8.7
1977,May,61.1,55.9,481532,440217,41315,8.6
1977,Jun,60.9,55.8,480887,440468,40419,8.4
1977,Jul,60.7,55.7,480034,440555,39479,8.2
1977,Aug,60.5,55.6,479154,440596,38558,8
1977,Sep,60.3,55.5,478420,440789,37631,7.9
1977,Oct,60.1,55.5,477895,441269,36626,7.7
1977,Nov,60,55.5,477591,442074,35517,7.4
1977,Dec,59.9,55.6,477461,443078,34383,7.2
1978,Jan,59.8,55.6,477478,444224,33254,7
1978,Feb,59.7,55.7,477685,445567,32118,6.7
1978,Mar,59.7,55.8,478247,447139,31108,6.5
1978,Apr,59.8,56,479238,448830,30408,6.3
1978,May,59.8,56,480665,450556,30109,6.3
1978,Jun,59.9,56.2,482411,452286,30125,6.2
1978,Jul,60.1,56.3,484304,453976,30328,6.3
1978,Aug,60.2,56.5,486159,455573,30586,6.3
1978,Sep,60.4,56.6,487773,456977,30796,6.3
1978,Oct,60.5,56.6,489144,458150,30994,6.3
1978,Nov,60.5,56.6,490327,459090,31237,6.4
1978,Dec,60.5,56.6,491389,459778,31611,6.4
1979,Jan,60.5,56.6,492253,460131,32122,6.5
1979,Feb,60.6,56.5,492899,460193,32706,6.6
1979,Mar,60.5,56.5,493374,460156,33218,6.7
1979,Apr,60.5,56.4,493870,460301,33569,6.8
1979,May,60.5,56.3,494673,460885,33788,6.8
1979,Jun,60.5,56.4,495880,461934,33946,6.8
1979,Jul,60.7,56.5,497462,463389,34073,6.8
1979,Aug,60.9,56.7,499318,465088,34230,6.9
1979,Sep,61.1,56.9,501274,466807,34467,6.9
1979,Oct,61.3,57,502937,468322,34615,6.9
1979,Nov,61.3,57.1,504112,469455,34657,6.9
1979,Dec,61.4,57.2,504859,470140,34719,6.9
1980,Jan,61.5,57.2,505405,470433,34972,6.9
1980,Feb,61.5,57.1,505790,470257,35533,7
1980,Mar,61.5,57.1,505948,469557,36391,7.2
1980,Apr,61.4,56.9,505938,468471,37467,7.4
1980,May,61.3,56.6,505815,467226,38589,7.6
1980,Jun,61.2,56.4,505718,466175,39543,7.8
1980,Jul,61.2,56.4,505709,465534,40175,7.9
1980,Aug,61.2,56.3,505821,465366,40455,8
1980,Sep,61.1,56.2,506054,465609,40445,8
1980,Oct,61.1,56.2,506426,466121,40305,8
1980,Nov,61.1,56.2,506857,466814,40043,7.9
1980,Dec,61.1,56.3,507194,467641,39553,7.8
1981,Jan,61.1,56.4,507450,468483,38967,7.7
1981,Feb,61,56.4,507769,469422,38347,7.6
1981,Mar,61,56.5,508261,470609,37652,7.4
1981,Apr,61,56.6,508770,471852,36918,7.3
1981,May,61.1,56.7,509193,472916,36277,7.1
1981,Jun,61,56.7,509580,473665,35915,7
1981,Jul,61,56.7,510029,474075,35954,7
1981,Aug,61,56.7,510537,474191,36346,7.1
1981,Sep,61.1,56.6,511096,474099,36997,7.2
1981,Oct,61.1,56.5,511747,473878,37869,7.4
1981,Nov,61.2,56.5,512454,473539,38915,7.6
1981,Dec,61.2,56.4,513261,473215,40046,7.8
1982,Jan,61.3,56.4,514155,473134,41021,8
1982,Feb,61.3,56.3,515136,473296,41840,8.1
1982,Mar,61.4,56.3,516143,473526,42617,8.3
1982,Apr,61.5,56.3,517117,473890,43227,8.4
1982,May,61.5,56.3,517974,474389,43585,8.4
1982,Jun,61.6,56.4,518601,474867,43734,8.4
1982,Jul,61.6,56.4,518996,475246,43750,8.4
1982,Aug,61.5,56.3,519351,475590,43761,8.4
1982,Sep,61.5,56.3,519964,476046,43918,8.4
1982,Oct,61.6,56.4,521017,476741,44276,8.5
1982,Nov,61.7,56.4,522553,477784,44769,8.6
1982,Dec,61.8,56.5,524473,479114,45359,8.6
1983,Jan,62.1,56.7,526547,480569,45978,8.7
1983,Feb,62.3,56.8,528599,482121,46478,8.8
1983,Mar,62.4,56.9,530586,483827,46759,8.8
1983,Apr,62.6,57.1,532554,485713,46841,8.8
1983,May,62.7,57.2,534423,487757,46666,8.7
1983,Jun,62.9,57.4,536114,489976,46138,8.6
1983,Jul,63,57.6,537600,492301,45299,8.4
1983,Aug,63,57.8,538819,494569,44250,8.2
1983,Sep,63.1,58,539733,496698,43035,8
1983,Oct,63.1,58.2,540480,498755,41725,7.7
1983,Nov,63.1,58.4,541249,500824,40425,7.5
1983,Dec,63.1,58.6,542173,502990,39183,7.2
1984,Jan,63.2,58.8,543335,505345,37990,7
1984,Feb,63.3,59,544746,507864,36882,6.8
1984,Mar,63.4,59.2,546275,510354,35921,6.6
1984,Apr,63.5,59.4,547660,512474,35186,6.4
1984,May,63.5,59.5,548664,513994,34670,6.3
1984,Jun,63.5,59.5,549130,514869,34261,6.2
1984,Jul,63.4,59.5,549048,515228,33820,6.2
1984,Aug,63.3,59.4,548624,515376,33248,6.1
1984,Sep,63.2,59.4,548209,515600,32609,5.9
1984,Oct,63.2,59.5,548145,516121,32024,5.8
1984,Nov,63.1,59.5,548699,517049,31650,5.8
1984,Dec,63.2,59.6,549830,518298,31532,5.7
1985,Jan,63.3,59.7,551145,519562,31583,5.7
1985,Feb,63.4,59.8,552086,520448,31638,5.7
1985,Mar,63.3,59.7,552214,520731,31483,5.7
1985,Apr,63.2,59.6,551550,520525,31025,5.6
1985,May,63,59.5,550519,520161,30358,5.5
1985,Jun,62.9,59.5,549646,519937,29709,5.4
1985,Jul,62.8,59.4,549363,520094,29269,5.3
1985,Aug,62.8,59.4,549921,520763,29158,5.3
1985,Sep,62.9,59.6,551248,521900,29348,5.3
1985,Oct,63.1,59.7,552959,523299,29660,5.4
1985,Nov,63.2,59.8,554635,524691,29944,5.4
1985,Dec,63.3,59.9,555982,525862,30120,5.4
1986,Jan,63.4,59.9,556936,526779,30157,5.4
1986,Feb,63.4,60,557685,527617,30068,5.4
1986,Mar,63.5,60.1,558502,528564,29938,5.4
1986,Apr,63.5,60.1,559548,529685,29863,5.3
1986,May,63.6,60.2,560781,530923,29858,5.3
1986,Jun,63.7,60.3,562111,532210,29901,5.3
1986,Jul,63.8,60.4,563434,533480,29954,5.3
1986,Aug,63.9,60.5,564603,534672,29931,5.3
1986,Sep,63.8,60.5,565566,535801,29765,5.3
1986,Oct,63.9,60.5,566437,537003,29434,5.2
1986,Nov,63.9,60.6,567339,538447,28892,5.1
1986,Dec,63.9,60.8,568506,540359,28147,5
1987,Jan,64,60.9,570225,542822,27403,4.8
1987,Feb,64.2,61.2,572464,545727,26737,4.7
1987,Mar,64.4,61.5,575128,548968,26160,4.5
1987,Apr,64.7,61.8,578210,552463,25747,4.5
1987,May,64.9,62.1,581622,556072,25550,4.4
1987,Jun,65.2,62.4,585118,559571,25547,4.4
1987,Jul,65.5,62.7,588366,562733,25633,4.4
1987,Aug,65.7,62.8,591069,565388,25681,4.3
1987,Sep,65.8,63,593003,567476,25527,4.3
1987,Oct,65.8,63,594044,568953,25091,4.2
1987,Nov,65.7,63,594274,569907,24367,4.1
1987,Dec,65.6,63,593912,570487,23425,3.9
1988,Jan,65.4,62.9,593268,570875,22393,3.8
1988,Feb,65.2,62.9,592874,571355,21519,3.6
1988,Mar,65.2,62.9,593120,572067,21053,3.5
1988,Apr,65.1,62.8,593965,572975,20990,3.5
1988,May,65.2,62.9,595332,574057,21275,3.6
1988,Jun,65.3,62.9,597172,575387,21785,3.6
1988,Jul,65.4,63,599303,576976,22327,3.7
1988,Aug,65.6,63.1,601405,578693,22712,3.8
1988,Sep,65.7,63.2,603165,580368,22797,3.8
1988,Oct,65.8,63.3,604354,581877,22477,3.7
1988,Nov,65.8,63.4,604936,583125,21811,3.6
1988,Dec,65.7,63.4,605119,584051,21068,3.5
1989,Jan,65.6,63.4,605279,584732,20547,3.4
1989,Feb,65.6,63.4,605767,585224,20543,3.4
1989,Mar,65.7,63.4,606864,585693,21171,3.5
1989,Apr,65.8,63.4,608742,586403,22339,3.7
1989,May,66,63.4,611235,587441,23794,3.9
1989,Jun,66.2,63.5,613915,588696,25219,4.1
1989,Jul,66.4,63.6,616414,590031,26383,4.3
1989,Aug,66.6,63.7,618585,591414,27171,4.4
1989,Sep,66.7,63.7,620413,592811,27602,4.4
1989,Oct,66.8,63.8,622015,594205,27810,4.5
1989,Nov,66.9,63.9,623498,595590,27908,4.5
1989,Dec,67,64,624902,596968,27934,4.5
1990,Jan,67.2,64.2,626301,598373,27928,4.5
1990,Feb,67.2,64.2,627771,599773,27998,4.5
1990,Mar,67.3,64.2,629208,600946,28262,4.5
1990,Apr,67.3,64.2,630411,601578,28833,4.6
1990,May,67.2,64.1,631337,601588,29749,4.7
1990,Jun,67.3,64,632100,601048,31052,4.9
1990,Jul,67.2,63.7,632834,600112,32722,5.2
1990,Aug,67.3,63.6,633731,599063,34668,5.5
1990,Sep,67.4,63.5,635124,598217,36907,5.8
1990,Oct,67.6,63.4,637264,597758,39506,6.2
1990,Nov,67.9,63.4,640207,597703,42504,6.6
1990,Dec,68.2,63.4,643633,597874,45759,7.1
1991,Jan,68.5,63.4,646787,597942,48845,7.6
1991,Feb,68.8,63.3,648924,597728,51196,7.9
1991,Mar,68.8,63.3,649647,597259,52388,8.1
1991,Apr,68.8,63.2,649032,596702,52330,8.1
1991,May,68.6,63.2,647409,596201,51208,7.9
1991,Jun,68.4,63.2,645280,595889,49391,7.7
1991,Jul,68.2,63.1,643262,595821,47441,7.4
1991,Aug,68,63.1,641896,595883,46013,7.2
1991,Sep,67.9,63.1,641385,595933,45452,7.1
1991,Oct,67.9,63.1,641663,595913,45750,7.1
1991,Nov,68,63.1,642494,595865,46629,7.3
1991,Dec,68.1,63.1,643570,595894,47676,7.4
1992,Jan,68.3,63.1,644653,596109,48544,7.5
1992,Feb,68.4,63.2,645530,596565,48965,7.6
1992,Mar,68.4,63.2,646117,597291,48826,7.6
1992,Apr,68.4,63.3,646380,598190,48190,7.5
1992,May,68.4,63.4,646336,599034,47302,7.3
1992,Jun,68.3,63.4,646104,599594,46510,7.2
1992,Jul,68.3,63.4,645783,599728,46055,7.1
1992,Aug,68.3,63.4,645234,599309,45925,7.1
1992,Sep,68.1,63.2,644160,598216,45944,7.1
1992,Oct,67.9,63,642393,596496,45897,7.1
1992,Nov,67.6,62.7,639941,594298,45643,7.1
1992,Dec,67.3,62.5,637107,591900,45207,7.1
1993,Jan,67,62.3,634388,589630,44758,7.1
1993,Feb,66.7,62,632153,587681,44472,7
1993,Mar,66.5,61.8,630586,586138,44448,7
1993,Apr,66.4,61.7,629718,584983,44735,7.1
1993,May,66.4,61.6,629378,584116,45262,7.2
1993,Jun,66.3,61.5,629231,583385,45846,7.3
1993,Jul,66.3,61.4,628936,582613,46323,7.4
1993,Aug,66.2,61.3,628349,581775,46574,7.4
1993,Sep,66.1,61.2,627599,580993,46606,7.4
1993,Oct,66,61.1,626792,580302,46490,7.4
1993,Nov,65.9,61,625927,579683,46244,7.4
1993,Dec,65.7,60.9,625022,579139,45883,7.3
1994,Jan,65.6,60.9,624064,578628,45436,7.3
1994,Feb,65.5,60.8,623091,578084,45007,7.2
1994,Mar,65.4,60.7,622136,577425,44711,7.2
1994,Apr,65.3,60.7,621192,576681,44511,7.2
1994,May,65.2,60.6,620367,575997,44370,7.2
1994,Jun,65.1,60.5,619779,575555,44224,7.1
1994,Jul,65.1,60.5,619541,575628,43913,7.1
1994,Aug,65.1,60.6,619761,576362,43399,7
1994,Sep,65.1,60.6,620460,577758,42702,6.9
1994,Oct,65.2,60.9,621571,579722,41849,6.7
1994,Nov,65.3,61,623034,582069,40965,6.6
1994,Dec,65.5,61.3,624722,584566,40156,6.4
1995,Jan,65.7,61.6,626577,587090,39487,6.3
1995,Feb,65.9,61.8,628602,589604,38998,6.2
1995,Mar,66.1,62,630736,592064,38672,6.1
1995,Apr,66.3,62.3,632953,594457,38496,6.1
1995,May,66.5,62.5,635190,596815,38375,6
1995,Jun,66.7,62.7,637364,599145,38219,6
1995,Jul,66.9,62.9,639351,601318,38033,5.9
1995,Aug,67,63.1,641047,603302,37745,5.9
1995,Sep,67.2,63.3,642499,605182,37317,5.8
1995,Oct,67.3,63.4,643886,607057,36829,5.7
1995,Nov,67.3,63.5,645391,609027,36364,5.6
1995,Dec,67.5,63.8,647037,611036,36001,5.6
1996,Jan,67.6,63.9,648716,612962,35754,5.5
1996,Feb,67.8,64.1,650424,614832,35592,5.5
1996,Mar,67.9,64.2,652229,616765,35464,5.4
1996,Apr,68,64.4,654069,618777,35292,5.4
1996,May,68.2,64.6,655829,620808,35021,5.3
1996,Jun,68.3,64.7,657431,622811,34620,5.3
1996,Jul,68.4,64.9,658809,624737,34072,5.2
1996,Aug,68.4,65,659899,626438,33461,5.1
1996,Sep,68.4,65,660569,627636,32933,5
1996,Oct,68.5,65.1,660756,628180,32576,4.9
1996,Nov,68.4,65,660612,628093,32519,4.9
1996,Dec,68.3,64.9,660390,627587,32803,5
1997,Jan,68.2,64.8,660208,626875,33333,5
1997,Feb,68.2,64.7,659972,626066,33906,5.1
1997,Mar,68.1,64.6,659581,625293,34288,5.2
1997,Apr,68,64.5,659035,624696,34339,5.2
1997,May,67.9,64.4,658285,624254,34031,5.2
1997,Jun,67.8,64.3,657302,623857,33445,5.1
1997,Jul,67.6,64.2,656193,623436,32757,5
1997,Aug,67.5,64.2,655166,622906,32260,4.9
1997,Sep,67.3,64,654350,622265,32085,4.9
1997,Oct,67.2,63.9,653754,621575,32179,4.9
1997,Nov,67.1,63.8,653234,620911,32323,4.9
1997,Dec,67.1,63.8,652690,620451,32239,4.9
1998,Jan,67,63.7,652124,620348,31776,4.9
1998,Feb,66.9,63.7,651575,620604,30971,4.8
1998,Mar,66.9,63.8,651080,621028,30052,4.6
1998,Apr,66.8,63.8,650749,621485,29264,4.5
1998,May,66.8,63.8,650779,621967,28812,4.4
1998,Jun,66.8,63.9,651302,622500,28802,4.4
1998,Jul,66.9,63.9,652238,623152,29086,4.5
1998,Aug,66.9,63.9,653367,624078,29289,4.5
1998,Sep,67,64,654534,625363,29171,4.5
1998,Oct,67.1,64.1,655696,626955,28741,4.4
1998,Nov,67.1,64.3,656753,628704,28049,4.3
1998,Dec,67.1,64.4,657658,630365,27293,4.2
1999,Jan,67.2,64.4,658526,631805,26721,4.1
1999,Feb,67.3,64.6,659538,633100,26438,4
1999,Mar,67.3,64.6,660831,634428,26403,4
1999,Apr,67.4,64.7,662472,635914,26558,4
1999,May,67.6,64.9,664504,637730,26774,4
1999,Jun,67.8,65.1,666847,639984,26863,4
1999,Jul,68,65.3,669339,642545,26794,4
1999,Aug,68.2,65.5,671857,645240,26617,4
1999,Sep,68.4,65.7,674263,647919,26344,3.9
1999,Oct,68.5,65.9,676417,650437,25980,3.8
1999,Nov,68.6,66,678308,652725,25583,3.8
1999,Dec,68.7,66.2,679906,654740,25166,3.7
2000,Jan,68.8,66.3,681087,656403,24684,3.6
2000,Feb,68.8,66.3,681766,657621,24145,3.5
2000,Mar,68.7,66.4,681964,658353,23611,3.5
2000,Apr,68.7,66.4,681675,658551,23124,3.4
2000,May,68.6,66.3,680794,658077,22717,3.3
2000,Jun,68.4,66.1,679395,656950,22445,3.3
2000,Jul,68.2,65.9,677792,655490,22302,3.3
2000,Aug,68,65.7,676247,654051,22196,3.3
2000,Sep,67.8,65.5,674992,652891,22101,3.3
2000,Oct,67.6,65.4,674135,652149,21986,3.3
2000,Nov,67.5,65.3,673671,651777,21894,3.2
2000,Dec,67.4,65.2,673584,651620,21964,3.3
2001,Jan,67.4,65.2,673783,651489,22294,3.3
2001,Feb,67.4,65.1,674128,651205,22923,3.4
2001,Mar,67.4,65,674428,650647,23781,3.5
2001,Apr,67.3,64.8,674575,649873,24702,3.7
2001,May,67.3,64.7,674676,649115,25561,3.8
2001,Jun,67.2,64.6,674794,648540,26254,3.9
2001,Jul,67.2,64.5,674849,648125,26724,4
2001,Aug,67.1,64.4,674788,647728,27060,4
2001,Sep,67,64.3,674535,647231,27304,4
2001,Oct,66.9,64.1,674081,646608,27473,4.1
2001,Nov,66.7,64,673480,645873,27607,4.1
2001,Dec,66.6,63.9,672810,645124,27686,4.1
2002,Jan,66.5,63.8,672274,644507,27767,4.1
2002,Feb,66.4,63.7,672098,644171,27927,4.2
2002,Mar,66.4,63.6,672400,644212,28188,4.2
2002,Apr,66.4,63.6,673143,644614,28529,4.2
2002,May,66.5,63.6,674111,645262,28849,4.3
2002,Jun,66.5,63.6,675067,645978,29089,4.3
2002,Jul,66.5,63.6,675858,646588,29270,4.3
2002,Aug,66.5,63.6,676473,647019,29454,4.4
2002,Sep,66.5,63.6,677033,647259,29774,4.4
2002,Oct,66.5,63.5,677668,647356,30312,4.5
2002,Nov,66.5,63.4,678485,647430,31055,4.6
2002,Dec,66.5,63.4,679486,647558,31928,4.7
2003,Jan,66.6,63.4,680540,647759,32781,4.8
2003,Feb,66.6,63.4,681480,648006,33474,4.9
2003,Mar,66.7,63.3,682201,648270,33931,5
2003,Apr,66.7,63.3,682688,648532,34156,5
2003,May,66.6,63.3,683021,648785,34236,5
2003,Jun,66.6,63.3,683365,649108,34257,5
2003,Jul,66.6,63.2,683813,649549,34264,5
2003,Aug,66.6,63.2,684314,650050,34264,5
2003,Sep,66.5,63.2,684763,650552,34211,5
2003,Oct,66.5,63.2,685078,650988,34090,5
2003,Nov,66.5,63.2,685183,651312,33871,4.9
2003,Dec,66.4,63.2,685052,651548,33504,4.9
2004,Jan,66.4,63.2,684777,651769,33008,4.8
2004,Feb,66.3,63.2,684474,652072,32402,4.7
2004,Mar,66.2,63.2,684286,652511,31775,4.6
2004,Apr,66.2,63.2,684313,653061,31252,4.6
2004,May,66.2,63.2,684555,653632,30923,4.5
2004,Jun,66.2,63.2,684992,654152,30840,4.5
2004,Jul,66.2,63.2,685601,654604,30997,4.5
2004,Aug,66.2,63.2,686320,654984,31336,4.6
2004,Sep,66.2,63.2,687078,655292,31786,4.6
2004,Oct,66.2,63.1,687801,655535,32266,4.7
2004,Nov,66.3,63.1,688506,655782,32724,4.8
2004,Dec,66.3,63.1,689347,656166,33181,4.8
2005,Jan,66.4,63.2,690412,656787,33625,4.9
2005,Feb,66.5,63.2,691709,657693,34016,4.9
2005,Mar,66.6,63.3,693205,658894,34311,4.9
2005,Apr,66.7,63.4,694842,660357,34485,5
2005,May,66.9,63.5,696537,661978,34559,5
2005,Jun,67,63.6,698109,663545,34564,5
2005,Jul,67,63.7,699369,664850,34519,4.9
2005,Aug,67.1,63.8,700223,665822,34401,4.9
2005,Sep,67.1,63.8,700637,666479,34158,4.9
2005,Oct,67,63.8,700687,666926,33761,4.8
2005,Nov,66.9,63.8,700509,667305,33204,4.7
2005,Dec,66.9,63.7,700196,667677,32519,4.6
2006,Jan,66.8,63.8,699919,668084,31835,4.5
2006,Feb,66.8,63.8,699784,668457,31327,4.5
2006,Mar,66.7,63.8,699813,668692,31121,4.4
2006,Apr,66.7,63.7,700001,668766,31235,4.5
2006,May,66.7,63.7,700322,668737,31585,4.5
2006,Jun,66.7,63.7,700777,668717,32060,4.6
2006,Jul,66.7,63.6,701393,668862,32531,4.6
2006,Aug,66.8,63.6,702152,669303,32849,4.7
2006,Sep,66.8,63.7,702971,670043,32928,4.7
2006,Oct,66.8,63.7,703721,670992,32729,4.7
2006,Nov,66.9,63.8,704221,671889,32332,4.6
2006,Dec,66.8,63.8,704291,672383,31908,4.5
2007,Jan,66.8,63.8,703834,672263,31571,4.5
2007,Feb,66.7,63.7,702958,671555,31403,4.5
2007,Mar,66.5,63.5,701834,670402,31432,4.5
2007,Apr,66.4,63.4,700643,668987,31656,4.5
2007,May,66.3,63.2,699615,667553,32062,4.6
2007,Jun,66.2,63.1,698916,666350,32566,4.7
2007,Jul,66.1,63,698634,665561,33073,4.7
2007,Aug,66.1,62.9,698792,665256,33536,4.8
2007,Sep,66.1,62.9,699325,665432,33893,4.8
2007,Oct,66.1,62.9,700049,665963,34086,4.9
2007,Nov,66.2,62.9,700821,666710,34111,4.9
2007,Dec,66.2,63,701552,667551,34001,4.8
2008,Jan,66.2,63,702139,668265,33874,4.8
2008,Feb,66.2,63.1,702566,668686,33880,4.8
2008,Mar,66.3,63,702891,668754,34137,4.9
2008,Apr,66.2,63,703117,668426,34691,4.9
2008,May,66.2,62.9,703179,667682,35497,5
2008,Jun,66.2,62.7,703014,666499,36515,5.2
2008,Jul,66.1,62.5,702556,664830,37726,5.4
2008,Aug,66,62.3,701831,662648,39183,5.6
2008,Sep,65.9,62.1,700983,659988,40995,5.8
2008,Oct,65.8,61.8,700183,656924,43259,6.2
2008,Nov,65.7,61.4,699534,653611,45923,6.6
2008,Dec,65.7,61.1,699094,650310,48784,7
2009,Jan,65.7,60.8,698856,647269,51587,7.4
2009,Feb,65.7,60.6,698671,644638,54033,7.7
2009,Mar,65.6,60.4,698393,642531,55862,8
2009,Apr,65.6,60.2,697986,641007,56979,8.2
2009,May,65.5,60.1,697409,639949,57460,8.2
2009,Jun,65.4,60,696683,639200,57483,8.3
2009,Jul,65.4,60,695896,638623,57273,8.2
2009,Aug,65.3,59.9,695121,638115,57006,8.2
2009,Sep,65.2,59.8,694464,637661,56803,8.2
2009,Oct,65.1,59.8,694026,637287,56739,8.2
2009,Nov,65.1,59.8,693876,637069,56807,8.2
2009,Dec,65.1,59.8,693985,637053,56932,8.2
2010,Jan,65.1,59.8,694243,637259,56984,8.2
2010,Feb,65.1,59.8,694475,637568,56907,8.2
2010,Mar,65.1,59.8,694551,637804,56747,8.2
2010,Apr,64.6,59.4,694445,637892,56553,8.1
2010,May,64.6,59.4,694263,637898,56365,8.1
2010,Jun,64.6,59.4,694172,637919,56253,8.1
2010,Jul,64.6,59.4,694326,638068,56258,8.1
2010,Aug,64.6,59.4,694797,638446,56351,8.1
2010,Sep,64.7,59.4,695496,639030,56466,8.1
2010,Oct,64.7,59.4,696286,639773,56513,8.1
2010,Nov,64.7,59.5,697017,640546,56471,8.1
2010,Dec,64.8,59.5,697569,641170,56399,8.1
2011,Jan,64.8,59.6,697917,641581,56336,8.1
2011,Feb,64.8,59.6,698122,641876,56246,8.1
2011,Mar,64.8,59.6,698290,642192,56098,8
2011,Apr,64.8,59.6,698498,642590,55908,8
2011,May,64.8,59.6,698778,643077,55701,8
2011,Jun,64.8,59.6,699095,643643,55452,7.9
2011,Jul,64.8,59.7,699417,644275,55142,7.9
2011,Aug,64.8,59.7,699732,644926,54806,7.8
2011,Sep,64.8,59.8,700037,645554,54483,7.8
2011,Oct,64.8,59.8,700335,646109,54226,7.7
2011,Nov,64.8,59.8,700617,646574,54043,7.7
2011,Dec,64.8,59.9,700893,646996,53897,7.7
2012,Jan,64.9,59.9,701198,647429,53769,7.7
2012,Feb,64.9,59.9,701539,647863,53676,7.7
2012,Mar,64.9,60,701851,648248,53603,7.6
2012,Apr,64.9,60,702059,648582,53477,7.6
2012,May,64.9,60,702207,648947,53260,7.6
2012,Jun,64.9,60,702345,649410,52935,7.5
2012,Jul,64.9,60.1,702503,649989,52514,7.5
2012,Aug,64.9,60.1,702735,650687,52048,7.4
2012,Sep,64.9,60.2,703085,651471,51614,7.3
2012,Oct,65,60.2,703508,652278,51230,7.3
2012,Nov,65,60.3,703960,653061,50899,7.2
2012,Dec,65,60.3,704418,653833,50585,7.2
2013,Jan,65,60.4,704819,654594,50225,7.1
2013,Feb,65.1,60.5,705153,655387,49766,7.1
2013,Mar,65.1,60.6,705438,656261,49177,7
2013,Apr,65.1,60.6,705741,657244,48497,6.9
2013,May,65.1,60.7,706045,658276,47769,6.8
2013,Jun,65.1,60.8,706309,659246,47063,6.7
2013,Jul,65.1,60.9,706447,660040,46407,6.6
2013,Aug,65.1,60.9,706313,660549,45764,6.5
2013,Sep,65,60.9,705866,660735,45131,6.4
2013,Oct,64.9,60.8,705193,660665,44528,6.3
2013,Nov,64.8,60.8,704399,660416,43983,6.2
2013,Dec,64.7,60.7,703514,660016,43498,6.2
2014,Jan,64.6,60.7,702680,659873,42807,6.1
2014,Feb,64.5,60.6,701531,659353,42178,6
2014,Mar,64.4,60.6,700411,658894,41517,5.9
2014,Apr,64.3,60.5,699286,658458,40828,5.8
2014,May,64.2,60.5,698114,657984,40130,5.7
2014,Jun,64,60.4,696914,657472,39442,5.7
2014,Jul,63.9,60.3,695717,656942,38775,5.6
2014,Aug,63.8,60.3,694591,656458,38133,5.5
2014,Sep,63.7,60.2,693527,656034,37493,5.4
2014,Oct,63.5,60.2,692411,655612,36799,5.3
2014,Nov,63.4,60.1,691163,655154,36009,5.2
2014,Dec,63.3,60.1,689844,654716,35128,5.1
2015,Jan,63.2,60,688572,654375,34197,5
2015,Feb,63.1,60,687279,653991,33288,4.8
2015,Mar,62.9,60,686056,653650,32406,4.7
2015,Apr,62.8,59.9,684922,653372,31550,4.6
2015,May,62.7,59.9,683865,653144,30721,4.5
2015,Jun,62.6,59.9,682852,652926,29926,4.4
2015,Jul,62.5,59.9,681899,652713,29186,4.3
2015,Aug,62.4,59.8,681068,652539,28529,4.2
2015,Sep,62.4,59.8,680513,652541,27972,4.1
2015,Oct,62.3,59.8,680417,652877,27540,4
2015,Nov,62.4,59.9,680886,653636,27250,4
2015,Dec,62.4,60,681856,654796,27060,4
2016,Jan,62.6,60.1,683163,656256,26907,3.9
2016,Feb,62.7,60.2,684668,657907,26761,3.9
2016,Mar,62.8,60.4,686265,659657,26608,3.9
2016,Apr,62.9,60.5,687866,661409,26457,3.8
2016,May,63.1,60.7,689420,663097,26323,3.8
2016,Jun,63.2,60.8,690907,664696,26211,3.8
2016,Jul,63.3,60.9,692302,666190,26112,3.8
2016,Aug,63.4,61,693590,667584,26006,3.7
2016,Sep,63.5,61.1,694732,668859,25873,3.7
2016,Oct,63.5,61.2,695680,670000,25680,3.7
2016,Nov,63.5,61.2,696425,671021,25404,3.6
2016,Dec,63.6,61.3,696972,671890,25082,3.6
2017,Jan,63.6,61.3,697362,672583,24779,3.6
2017,Feb,63.6,61.4,697622,673093,24529,3.5
2017,Mar,63.6,61.4,697763,673414,24349,3.5
2017,Apr,63.6,61.4,697864,673642,24222,3.5
2017,May,63.6,61.4,697957,673861,24096,3.5
2017,Jun,63.5,61.4,697997,674071,23926,3.4
2017,Jul,63.5,61.4,697961,674279,23682,3.4
2017,Aug,63.5,61.3,697809,674464,23345,3.3
2017,Sep,63.4,61.3,697541,674605,22936,3.3
2017,Oct,63.3,61.3,697219,674703,22516,3.2
2017,Nov,63.3,61.3,696903,674744,22159,3.2
2017,Dec,63.3,61.3,696687,674776,21911,3.1
2018,Jan,63.2,61.3,696632,674833,21799,3.1
2018,Feb,63.2,61.2,696733,674892,21841,3.1
2018,Mar,63.2,61.2,696866,674850,22016,3.2
2018,Apr,63.2,61.2,696824,674557,22267,3.2
2018,May,63.1,61.1,696527,673995,22532,3.2
2018,Jun,63.1,61,696051,673302,22749,3.3
2018,Jul,63,60.9,695495,672617,22878,3.3
2018,Aug,62.9,60.8,695006,672071,22935,3.3
2018,Sep,62.8,60.8,694698,671758,22940,3.3
2018,Oct,62.8,60.7,694573,671666,22907,3.3
2018,Nov,62.8,60.7,694538,671695,22843,3.3
2018,Dec,62.7,60.7,694432,671694,22738,3.3
2019,Jan,62.7,60.6,694085,671537,22548,3.2
2019,Feb,62.6,60.6,693390,671170,22220,3.2
2019,Mar,62.5,60.5,692476,670722,21754,3.1
2019,Apr,62.4,60.5,691620,670413,21207,3.1
2019,May,62.3,60.4,691074,670402,20672,3
2019,Jun,62.3,60.4,690978,670722,20256,2.9
2019,Jul,62.3,60.5,691444,671381,20063,2.9
2019,Aug,62.3,60.5,692182,672083,20099,2.9
2019,Sep,62.3,60.5,693045,672746,20299,2.9
2019,Oct,62.4,60.5,693661,673135,20526,3
2019,Nov,62.3,60.5,693715,673084,20631,3
2019,Dec,62.3,60.5,693630,672992,20638,3
2020,Jan,62.3,60.4,694174,672966,21208,3.1
2020,Feb,62.4,60.4,695029,672993,22036,3.2
2020,Mar,62.4,60.5,695329,674282,21047,3
2020,Apr,59.1,52.9,658950,590147,68803,10.4
2020,May,59.7,54.1,665863,603171,62692,9.4
2020,Jun,60,56,669925,624932,44993,6.7
2020,Jul,62.5,56.3,697299,628564,68735,9.9
2020,Aug,60.7,56.4,677695,630465,47230,7
2020,Sep,60.9,57.2,681209,639836,41373,6.1
