Year,Period,labor force participation rate,employment-population ratio,labor force,employment,unemployment,unemployment rate
1976,Jan,65.7,61.8,1832797,1722777,110020,6
1976,Feb,65.6,61.7,1832001,1722014,109987,6
1976,Mar,65.5,61.6,1831869,1722985,108884,5.9
1976,Apr,65.5,61.7,1834864,1728543,106321,5.8
1976,May,65.6,61.9,1839691,1735701,103990,5.7
1976,Jun,65.7,62,1846239,1743269,102970,5.6
1976,Jul,65.8,62.2,1853353,1749692,103661,5.6
1976,Aug,66,62.2,1860375,1754797,105578,5.7
1976,Sep,66.1,62.3,1867208,1759571,107637,5.8
1976,Oct,66.3,62.4,1873748,1764368,109380,5.8
1976,Nov,66.4,62.5,1879929,1769422,110507,5.9
1976,Dec,66.5,62.6,1885780,1774870,110910,5.9
1977,Jan,66.6,62.7,1891668,1780883,110785,5.9
1977,Feb,66.7,62.9,1897597,1787467,110130,5.8
1977,Mar,66.8,63,1903458,1794378,109080,5.7
1977,Apr,66.9,63.2,1908978,1801328,107650,5.6
1977,May,67,63.3,1913748,1807886,105862,5.5
1977,Jun,67,63.4,1917528,1813744,103784,5.4
1977,Jul,67,63.5,1920289,1818921,101368,5.3
1977,Aug,67,63.6,1922544,1823778,98766,5.1
1977,Sep,67,63.7,1924827,1828891,95936,5
1977,Oct,67,63.8,1927399,1834724,92675,4.8
1977,Nov,67.1,64,1930534,1841465,89069,4.6
1977,Dec,67.1,64.1,1934423,1848898,85525,4.4
1978,Jan,67.2,64.3,1938776,1856608,82168,4.2
1978,Feb,67.2,64.5,1943417,1864157,79260,4.1
1978,Mar,67.3,64.7,1948388,1871366,77022,4
1978,Apr,67.4,64.8,1953791,1878366,75425,3.9
1978,May,67.5,65,1959830,1885393,74437,3.8
1978,Jun,67.7,65.1,1966430,1892564,73866,3.8
1978,Jul,67.8,65.3,1973568,1899756,73812,3.7
1978,Aug,68,65.5,1980861,1906706,74155,3.7
1978,Sep,68.1,65.6,1987751,1913144,74607,3.8
1978,Oct,68.3,65.7,1994046,1919022,75024,3.8
1978,Nov,68.4,65.8,1999721,1924283,75438,3.8
1978,Dec,68.5,65.9,2005015,1928907,76108,3.8
1979,Jan,68.5,65.9,2010310,1933137,77173,3.8
1979,Feb,68.6,65.9,2015861,1937447,78414,3.9
1979,Mar,68.7,66,2021836,1942152,79684,3.9
1979,Apr,68.9,66.1,2028451,1947250,81201,4
1979,May,69,66.2,2035705,1952728,82977,4.1
1979,Jun,69.2,66.3,2043308,1958432,84876,4.2
1979,Jul,69.3,66.4,2050709,1964118,86591,4.2
1979,Aug,69.4,66.5,2057777,1969407,88370,4.3
1979,Sep,69.6,66.5,2064756,1973901,90855,4.4
1979,Oct,69.7,66.5,2071377,1977432,93945,4.5
1979,Nov,69.8,66.5,2077588,1980065,97523,4.7
1979,Dec,69.9,66.5,2083406,1981965,101441,4.9
1980,Jan,69.9,66.4,2088673,1983093,105580,5.1
1980,Feb,70,66.3,2093427,1983277,110150,5.3
1980,Mar,70,66.2,2097618,1982529,115089,5.5
1980,Apr,70,66,2101069,1981174,119895,5.7
1980,May,70,65.9,2103788,1979682,124106,5.9
1980,Jun,70,65.8,2105989,1978697,127292,6
1980,Jul,70,65.7,2107734,1978800,128934,6.1
1980,Aug,70,65.7,2109097,1980276,128821,6.1
1980,Sep,69.9,65.7,2110309,1982987,127322,6
1980,Oct,69.9,65.8,2111880,1986380,125500,5.9
1980,Nov,69.9,65.8,2113801,1989941,123860,5.9
1980,Dec,69.9,65.8,2115703,1993277,122426,5.8
1981,Jan,69.9,65.9,2117632,1996012,121620,5.7
1981,Feb,69.9,65.9,2119052,1997943,121109,5.7
1981,Mar,69.8,65.8,2119345,1999171,120174,5.7
1981,Apr,69.7,65.8,2118529,1999916,118613,5.6
1981,May,69.6,65.8,2117185,2000334,116851,5.5
1981,Jun,69.5,65.7,2116302,2000483,115819,5.5
1981,Jul,69.5,65.6,2116976,2000420,116556,5.5
1981,Aug,69.5,65.6,2119387,2000167,119220,5.6
1981,Sep,69.6,65.5,2122914,1999730,123184,5.8
1981,Oct,69.6,65.5,2126921,1999119,127802,6
1981,Nov,69.7,65.4,2130693,1998117,132576,6.2
1981,Dec,69.8,65.3,2133925,1996665,137260,6.4
1982,Jan,69.8,65.2,2136398,1995016,141382,6.6
1982,Feb,69.8,65.1,2138618,1993296,145322,6.8
1982,Mar,69.9,65,2141510,1991359,150151,7
1982,Apr,70,64.9,2145306,1989106,156200,7.3
1982,May,70.1,64.8,2149558,1986619,162939,7.6
1982,Jun,70.2,64.6,2153826,1984023,169803,7.9
1982,Jul,70.2,64.5,2157753,1981394,176359,8.2
1982,Aug,70.3,64.4,2161173,1978977,182196,8.4
1982,Sep,70.4,64.3,2164078,1977077,187001,8.6
1982,Oct,70.4,64.3,2166328,1975800,190528,8.8
1982,Nov,70.5,64.2,2167871,1975301,192570,8.9
1982,Dec,70.5,64.2,2168631,1975558,193073,8.9
1983,Jan,70.5,64.2,2169076,1976498,192578,8.9
1983,Feb,70.4,64.2,2169708,1978461,191247,8.8
1983,Mar,70.4,64.3,2170531,1981752,188779,8.7
1983,Apr,70.5,64.4,2171677,1986269,185408,8.5
1983,May,70.5,64.6,2173207,1991654,181553,8.4
1983,Jun,70.5,64.8,2174739,1997511,177228,8.1
1983,Jul,70.5,64.9,2175942,2003426,172516,7.9
1983,Aug,70.5,65.1,2176892,2009001,167891,7.7
1983,Sep,70.5,65.2,2177871,2014150,163721,7.5
1983,Oct,70.5,65.3,2179168,2019135,160033,7.3
1983,Nov,70.5,65.5,2181306,2024359,156947,7.2
1983,Dec,70.6,65.6,2184663,2030190,154473,7.1
1984,Jan,70.7,65.8,2188766,2036704,152062,6.9
1984,Feb,70.8,66,2192840,2043477,149363,6.8
1984,Mar,70.9,66.1,2196576,2049973,146603,6.7
1984,Apr,70.9,66.3,2199591,2055830,143761,6.5
1984,May,71,66.4,2201683,2060800,140883,6.4
1984,Jun,70.9,66.5,2202870,2064921,137949,6.3
1984,Jul,70.9,66.6,2203574,2068507,135067,6.1
1984,Aug,70.9,66.7,2204644,2071827,132817,6
1984,Sep,71,66.7,2206465,2074983,131482,6
1984,Oct,71,66.8,2208906,2078100,130806,5.9
1984,Nov,71.1,66.9,2211738,2081142,130596,5.9
1984,Dec,71.2,67,2214567,2083935,130632,5.9
1985,Jan,71.2,67,2217003,2086324,130679,5.9
1985,Feb,71.3,67.1,2218942,2088153,130789,5.9
1985,Mar,71.3,67.1,2220295,2089492,130803,5.9
1985,Apr,71.3,67.1,2221367,2090656,130711,5.9
1985,May,71.3,67.1,2223022,2091962,131060,5.9
1985,Jun,71.4,67.1,2225647,2093481,132166,5.9
1985,Jul,71.5,67.2,2229070,2095167,133903,6
1985,Aug,71.5,67.1,2232462,2097048,135414,6.1
1985,Sep,71.5,67.1,2235303,2098976,136327,6.1
1985,Oct,71.5,67.1,2237462,2100633,136829,6.1
1985,Nov,71.4,67,2238605,2101827,136778,6.1
1985,Dec,71.3,67,2238733,2102634,136099,6.1
1986,Jan,71.2,66.9,2238380,2103352,135028,6
1986,Feb,71.1,66.9,2238201,2104493,133708,6
1986,Mar,71.1,66.9,2238312,2106346,131966,5.9
1986,Apr,71,66.9,2238762,2108933,129829,5.8
1986,May,70.9,66.9,2239294,2112158,127136,5.7
1986,Jun,70.8,66.9,2239974,2115745,124229,5.5
1986,Jul,70.8,66.9,2240640,2119226,121414,5.4
1986,Aug,70.7,67,2241200,2122289,118911,5.3
1986,Sep,70.7,67,2242163,2125033,117130,5.2
1986,Oct,70.7,67,2244249,2127796,116453,5.2
1986,Nov,70.8,67.1,2247864,2130920,116944,5.2
1986,Dec,70.9,67.2,2252896,2134747,118149,5.2
1987,Jan,71,67.2,2258791,2139276,119515,5.3
1987,Feb,71.1,67.3,2264613,2144173,120440,5.3
1987,Mar,71.2,67.4,2269933,2149085,120848,5.3
1987,Apr,71.3,67.5,2274429,2153645,120784,5.3
1987,May,71.3,67.6,2277845,2157685,120160,5.3
1987,Jun,71.4,67.7,2280672,2161419,119253,5.2
1987,Jul,71.4,67.7,2283641,2165301,118340,5.2
1987,Aug,71.4,67.8,2286816,2169551,117265,5.1
1987,Sep,71.4,67.8,2289373,2174088,115285,5
1987,Oct,71.4,67.9,2290737,2178649,112088,4.9
1987,Nov,71.3,67.9,2291012,2183011,108001,4.7
1987,Dec,71.2,68,2290842,2186921,103921,4.5
1988,Jan,71.1,68,2290812,2190303,100509,4.4
1988,Feb,71.1,68,2291582,2193384,98198,4.3
1988,Mar,71,68,2293690,2196387,97303,4.2
1988,Apr,71.1,68,2297153,2199532,97621,4.2
1988,May,71.1,68.1,2301552,2202900,98652,4.3
1988,Jun,71.2,68.1,2306060,2206413,99647,4.3
1988,Jul,71.2,68.1,2310012,2209998,100014,4.3
1988,Aug,71.3,68.2,2313683,2213642,100041,4.3
1988,Sep,71.3,68.2,2317501,2217417,100084,4.3
1988,Oct,71.4,68.3,2321106,2221344,99762,4.3
1988,Nov,71.5,68.4,2324362,2225332,99030,4.3
1988,Dec,71.5,68.5,2327380,2229224,98156,4.2
1989,Jan,71.6,68.6,2330493,2233045,97448,4.2
1989,Feb,71.6,68.6,2334032,2236703,97329,4.2
1989,Mar,71.7,68.7,2337986,2240184,97802,4.2
1989,Apr,71.8,68.8,2342265,2243495,98770,4.2
1989,May,71.9,68.8,2346710,2246599,100111,4.3
1989,Jun,72,68.9,2350913,2249490,101423,4.3
1989,Jul,72,68.9,2354622,2252096,102526,4.4
1989,Aug,72.1,68.9,2357812,2254503,103309,4.4
1989,Sep,72.1,68.9,2360970,2256959,104011,4.4
1989,Oct,72.2,69,2364936,2259807,105129,4.4
1989,Nov,72.3,69,2369848,2263155,106693,4.5
1989,Dec,72.4,69.1,2375231,2266859,108372,4.6
1990,Jan,73.2,69.8,2380233,2270552,109681,4.6
1990,Feb,73.2,69.8,2384131,2273917,110214,4.6
1990,Mar,73.2,69.9,2386911,2276830,110081,4.6
1990,Apr,73.2,69.9,2389163,2279322,109841,4.6
1990,May,73.2,69.8,2391794,2281576,110218,4.6
1990,Jun,73.3,69.9,2395288,2283716,111572,4.7
1990,Jul,73.3,69.9,2399765,2285894,113871,4.7
1990,Aug,73.4,69.9,2404616,2288111,116505,4.8
1990,Sep,73.5,69.9,2408908,2290090,118818,4.9
1990,Oct,73.5,69.8,2412247,2291522,120725,5
1990,Nov,73.5,69.8,2414646,2292425,122221,5.1
1990,Dec,73.5,69.7,2416354,2292975,123379,5.1
1991,Jan,73.5,69.7,2418022,2293395,124627,5.2
1991,Feb,73.5,69.6,2420081,2294029,126052,5.2
1991,Mar,73.5,69.6,2422262,2295035,127227,5.3
1991,Apr,73.5,69.6,2424233,2296521,127712,5.3
1991,May,73.4,69.6,2425844,2298578,127266,5.2
1991,Jun,73.4,69.6,2427273,2301094,126179,5.2
1991,Jul,73.4,69.6,2428612,2303687,124925,5.1
1991,Aug,73.4,69.6,2430081,2306082,123999,5.1
1991,Sep,73.3,69.6,2431937,2308214,123723,5.1
1991,Oct,73.3,69.6,2434004,2310149,123855,5.1
1991,Nov,73.3,69.6,2436144,2312146,123998,5.1
1991,Dec,73.3,69.6,2438527,2314592,123935,5.1
1992,Jan,73.4,69.6,2441497,2317774,123723,5.1
1992,Feb,73.4,69.7,2445395,2321748,123647,5.1
1992,Mar,73.5,69.8,2450471,2326458,124013,5.1
1992,Apr,73.6,69.9,2456583,2331564,125019,5.1
1992,May,73.8,70,2462891,2336586,126305,5.1
1992,Jun,73.9,70.1,2468655,2341259,127396,5.2
1992,Jul,74,70.1,2473592,2345578,128014,5.2
1992,Aug,74,70.2,2477628,2349573,128055,5.2
1992,Sep,74,70.2,2481025,2353324,127701,5.1
1992,Oct,74,70.2,2484370,2357066,127304,5.1
1992,Nov,74,70.2,2488044,2360813,127231,5.1
1992,Dec,74,70.2,2492183,2364544,127639,5.1
1993,Jan,74.1,70.2,2496791,2368312,128479,5.1
1993,Feb,74.1,70.3,2501662,2372110,129552,5.2
1993,Mar,74.2,70.3,2506410,2375998,130412,5.2
1993,Apr,74.2,70.4,2510345,2379932,130413,5.2
1993,May,74.2,70.4,2513295,2383817,129478,5.2
1993,Jun,74.2,70.4,2515565,2387732,127833,5.1
1993,Jul,74.2,70.5,2517417,2391894,125523,5
1993,Aug,74.1,70.5,2519561,2396522,123039,4.9
1993,Sep,74.1,70.6,2522573,2401759,120814,4.8
1993,Oct,74.1,70.6,2526632,2407430,119202,4.7
1993,Nov,74.2,70.7,2531618,2413243,118375,4.7
1993,Dec,74.3,70.8,2536726,2419063,117663,4.6
1994,Jan,74.3,70.9,2540841,2424787,116054,4.6
1994,Feb,74.3,71,2543268,2430187,113081,4.4
1994,Mar,74.2,71.1,2544271,2435036,109235,4.3
1994,Apr,74.2,71.1,2544912,2439560,105352,4.1
1994,May,74.1,71.2,2546361,2444089,102272,4
1994,Jun,74.1,71.2,2549142,2448709,100433,3.9
1994,Jul,74.2,71.3,2553450,2453500,99950,3.9
1994,Aug,74.2,71.3,2558919,2458543,100376,3.9
1994,Sep,74.3,71.4,2565028,2463986,101042,3.9
1994,Oct,74.4,71.5,2571084,2469877,101207,3.9
1994,Nov,74.5,71.6,2576619,2476092,100527,3.9
1994,Dec,74.5,71.7,2581596,2482075,99521,3.9
1995,Jan,74.6,71.7,2585994,2487331,98663,3.8
1995,Feb,74.6,71.8,2590013,2491849,98164,3.8
1995,Mar,74.7,71.8,2593696,2495787,97909,3.8
1995,Apr,74.7,71.9,2596775,2499174,97601,3.8
1995,May,74.7,71.9,2599328,2502265,97063,3.7
1995,Jun,74.6,71.9,2601710,2505429,96281,3.7
1995,Jul,74.6,71.9,2604297,2508775,95522,3.7
1995,Aug,74.6,71.9,2607286,2512192,95094,3.6
1995,Sep,74.6,71.9,2610669,2515478,95191,3.6
1995,Oct,74.6,71.9,2614576,2518567,96009,3.7
1995,Nov,74.6,71.8,2619111,2521491,97620,3.7
1995,Dec,74.7,71.9,2624187,2524356,99831,3.8
1996,Jan,74.8,71.9,2629620,2527318,102302,3.9
1996,Feb,74.8,71.9,2635184,2530462,104722,4
1996,Mar,74.9,71.9,2640731,2533903,106828,4
1996,Apr,75,71.9,2646070,2537763,108307,4.1
1996,May,75,71.9,2650775,2541989,108786,4.1
1996,Jun,75,72,2654642,2546392,108250,4.1
1996,Jul,75,72,2657775,2550804,106971,4
1996,Aug,75,72,2660238,2554945,105293,4
1996,Sep,75,72,2661939,2558447,103492,3.9
1996,Oct,74.9,72,2662772,2561173,101599,3.8
1996,Nov,74.8,72,2662878,2563288,99590,3.7
1996,Dec,74.7,72,2662705,2565208,97497,3.7
1997,Jan,74.6,72,2662883,2567298,95585,3.6
1997,Feb,74.6,72,2663711,2569931,93780,3.5
1997,Mar,74.6,72,2665342,2573419,91923,3.4
1997,Apr,74.6,72.1,2668227,2577907,90320,3.4
1997,May,74.7,72.2,2672438,2583236,89202,3.3
1997,Jun,74.7,72.3,2677436,2589074,88362,3.3
1997,Jul,74.8,72.4,2682412,2595033,87379,3.3
1997,Aug,74.8,72.4,2686805,2600764,86041,3.2
1997,Sep,74.9,72.5,2690360,2605980,84380,3.1
1997,Oct,74.8,72.5,2693139,2610466,82673,3.1
1997,Nov,74.8,72.6,2695115,2614270,80845,3
1997,Dec,74.8,72.6,2696571,2617785,78786,2.9
1998,Jan,74.8,72.7,2698132,2621429,76703,2.8
1998,Feb,74.8,72.7,2700064,2625295,74769,2.8
1998,Mar,74.8,72.8,2702105,2629140,72965,2.7
1998,Apr,74.8,72.8,2704062,2632660,71402,2.6
1998,May,74.8,72.8,2706060,2635609,70451,2.6
1998,Jun,74.8,72.8,2708375,2637989,70386,2.6
1998,Jul,74.8,72.8,2711325,2640015,71310,2.6
1998,Aug,74.8,72.8,2714928,2642208,72720,2.7
1998,Sep,74.8,72.7,2718945,2644991,73954,2.7
1998,Oct,74.8,72.7,2722685,2648442,74243,2.7
1998,Nov,74.8,72.8,2725659,2652357,73302,2.7
1998,Dec,74.7,72.8,2727890,2656366,71524,2.6
1999,Jan,74.7,72.8,2729728,2660142,69586,2.5
1999,Feb,74.7,72.8,2732461,2663708,68753,2.5
1999,Mar,74.7,72.8,2737219,2667336,69883,2.6
1999,Apr,74.8,72.8,2743773,2671074,72699,2.6
1999,May,74.9,72.9,2750956,2674865,76091,2.8
1999,Jun,75,72.9,2757618,2678615,79003,2.9
1999,Jul,75.1,72.9,2762803,2682199,80604,2.9
1999,Aug,75.1,72.9,2766410,2685554,80856,2.9
1999,Sep,75,72.9,2769202,2688868,80334,2.9
1999,Oct,75,72.9,2772433,2692424,80009,2.9
1999,Nov,75,72.9,2776905,2696482,80423,2.9
1999,Dec,75.1,72.9,2782654,2701003,81651,2.9
2000,Jan,75.2,73,2789080,2705802,83278,3
2000,Feb,75.3,73,2794851,2710434,84417,3
2000,Mar,75.3,73,2799169,2714446,84723,3
2000,Apr,75.3,73.1,2802390,2717820,84570,3
2000,May,75.3,73.1,2805323,2720697,84626,3
2000,Jun,75.4,73.1,2808736,2723118,85618,3
2000,Jul,75.4,73,2813086,2725381,87705,3.1
2000,Aug,75.4,73,2818258,2727914,90344,3.2
2000,Sep,75.5,73,2823635,2730936,92699,3.3
2000,Oct,75.5,73,2828747,2734499,94248,3.3
2000,Nov,75.6,73,2833383,2738196,95187,3.4
2000,Dec,75.6,73,2837269,2741383,95886,3.4
2001,Jan,75.6,73,2840164,2743530,96634,3.4
2001,Feb,75.6,73,2842233,2744381,97852,3.4
2001,Mar,75.5,72.9,2843436,2743893,99543,3.5
2001,Apr,75.4,72.7,2843564,2742210,101354,3.6
2001,May,75.3,72.6,2842942,2739983,102959,3.6
2001,Jun,75.2,72.5,2842222,2737922,104300,3.7
2001,Jul,75.1,72.3,2842199,2736380,105819,3.7
2001,Aug,75.1,72.2,2843346,2735179,108167,3.8
2001,Sep,75.1,72.1,2845757,2734088,111669,3.9
2001,Oct,75.1,72,2849013,2732967,116046,4.1
2001,Nov,75.1,71.9,2852581,2731699,120882,4.2
2001,Dec,75.1,71.8,2855900,2730358,125542,4.4
2002,Jan,75.1,71.7,2858370,2729028,129342,4.5
2002,Feb,75.1,71.6,2859741,2727925,131816,4.6
2002,Mar,75.1,71.6,2860206,2727347,132859,4.6
2002,Apr,75,71.5,2860264,2727633,132631,4.6
2002,May,74.9,71.5,2860212,2728728,131484,4.6
2002,Jun,74.9,71.5,2860082,2730401,129681,4.5
2002,Jul,74.8,71.4,2859793,2732182,127611,4.5
2002,Aug,74.7,71.4,2859536,2733638,125898,4.4
2002,Sep,74.6,71.4,2859576,2734464,125112,4.4
2002,Oct,74.6,71.3,2859769,2734542,125227,4.4
2002,Nov,74.5,71.2,2860212,2734220,125992,4.4
2002,Dec,74.5,71.2,2861157,2733911,127246,4.4
2003,Jan,74.5,71.1,2863044,2733890,129154,4.5
2003,Feb,74.5,71.1,2865861,2734182,131679,4.6
2003,Mar,74.6,71.1,2869236,2734627,134609,4.7
2003,Apr,74.6,71,2872705,2734963,137742,4.8
2003,May,74.6,71,2875787,2734940,140847,4.9
2003,Jun,74.6,70.9,2878188,2734622,143566,5
2003,Jul,74.6,70.8,2879556,2734165,145391,5
2003,Aug,74.5,70.7,2879792,2733711,146081,5.1
2003,Sep,74.4,70.7,2878962,2733410,145552,5.1
2003,Oct,74.3,70.6,2877796,2733303,144493,5
2003,Nov,74.3,70.6,2876833,2733535,143298,5
2003,Dec,74.2,70.5,2876224,2734333,141891,4.9
2004,Jan,74.2,70.5,2876103,2735760,140343,4.9
2004,Feb,74.1,70.6,2876495,2737735,138760,4.8
2004,Mar,74.1,70.6,2877616,2740027,137589,4.8
2004,Apr,74.1,70.6,2879285,2742219,137066,4.8
2004,May,74.1,70.6,2881116,2744084,137032,4.8
2004,Jun,74.1,70.5,2882707,2745591,137116,4.8
2004,Jul,74,70.5,2883868,2746966,136902,4.7
2004,Aug,74,70.5,2884171,2748355,135816,4.7
2004,Sep,73.9,70.5,2883214,2749624,133590,4.6
2004,Oct,73.8,70.5,2880983,2750503,130480,4.5
2004,Nov,73.7,70.4,2877921,2750890,127031,4.4
2004,Dec,73.6,70.4,2875306,2751072,124234,4.3
2005,Jan,73.5,70.3,2873921,2751548,122373,4.3
2005,Feb,73.4,70.3,2873789,2752631,121158,4.2
2005,Mar,73.4,70.3,2874411,2754552,119859,4.2
2005,Apr,73.4,70.4,2875367,2757321,118046,4.1
2005,May,73.3,70.4,2876514,2760640,115874,4
2005,Jun,73.3,70.4,2877789,2763859,113930,4
2005,Jul,73.3,70.4,2879213,2766329,112884,3.9
2005,Aug,73.3,70.4,2880941,2767972,112969,3.9
2005,Sep,73.3,70.4,2883421,2769184,114237,4
2005,Oct,73.2,70.3,2886643,2770439,116204,4
2005,Nov,73.2,70.2,2889921,2771757,118164,4.1
2005,Dec,73.2,70.2,2891905,2772670,119235,4.1
2006,Jan,73.1,70.1,2891833,2773083,118750,4.1
2006,Feb,73,70.1,2890024,2773084,116940,4
2006,Mar,72.9,70,2887173,2772660,114513,4
2006,Apr,72.8,70,2884084,2771919,112165,3.9
2006,May,72.7,69.9,2881531,2771090,110441,3.8
2006,Jun,72.6,69.8,2880271,2770385,109886,3.8
2006,Jul,72.5,69.7,2880828,2770115,110713,3.8
2006,Aug,72.5,69.7,2883406,2770375,113031,3.9
2006,Sep,72.5,69.6,2887416,2771072,116344,4
2006,Oct,72.6,69.6,2891843,2772212,119631,4.1
2006,Nov,72.6,69.5,2896042,2773633,122409,4.2
2006,Dec,72.6,69.5,2899583,2775034,124549,4.3
2007,Jan,72.6,69.5,2902180,2775988,126192,4.3
2007,Feb,72.6,69.4,2903772,2776322,127450,4.4
2007,Mar,72.6,69.4,2904432,2776056,128376,4.4
2007,Apr,72.5,69.3,2904623,2775347,129276,4.5
2007,May,72.5,69.2,2904924,2774409,130515,4.5
2007,Jun,72.4,69.1,2905474,2773511,131963,4.5
2007,Jul,72.4,69.1,2906293,2772797,133496,4.6
2007,Aug,72.4,69,2907313,2772300,135013,4.6
2007,Sep,72.3,68.9,2908243,2772053,136190,4.7
2007,Oct,72.3,68.9,2908861,2772027,136834,4.7
2007,Nov,72.2,68.8,2908992,2772260,136732,4.7
2007,Dec,72.2,68.8,2908891,2772662,136229,4.7
2008,Jan,72.1,68.7,2909013,2772826,136187,4.7
2008,Feb,72.1,68.7,2909787,2772517,137270,4.7
2008,Mar,72.1,68.6,2911762,2771800,139962,4.8
2008,Apr,72.1,68.6,2915042,2770889,144153,4.9
2008,May,72.2,68.5,2919227,2770044,149183,5.1
2008,Jun,72.2,68.4,2923829,2769395,154434,5.3
2008,Jul,72.3,68.3,2928191,2768735,159456,5.4
2008,Aug,72.3,68.3,2931765,2767588,164177,5.6
2008,Sep,72.3,68.1,2934806,2765254,169552,5.8
2008,Oct,72.3,68,2937794,2761107,176687,6
2008,Nov,72.4,67.8,2940901,2754990,185911,6.3
2008,Dec,72.4,67.6,2943948,2747438,196510,6.7
2009,Jan,72.4,67.3,2946821,2739235,207586,7
2009,Feb,72.4,67.1,2949309,2731319,217990,7.4
2009,Mar,72.4,66.9,2951059,2724675,226384,7.7
2009,Apr,72.4,66.7,2951603,2719566,232037,7.9
2009,May,72.3,66.6,2950545,2715505,235040,8
2009,Jun,72.2,66.4,2947998,2712019,235979,8
2009,Jul,72.1,66.3,2944238,2708803,235435,8
2009,Aug,71.9,66.2,2939740,2705818,233922,8
2009,Sep,71.8,66.1,2935146,2703348,231798,7.9
2009,Oct,71.6,66,2931271,2701677,229594,7.8
2009,Nov,71.5,65.9,2929236,2701297,227939,7.8
2009,Dec,71.5,65.9,2929562,2702551,227011,7.7
2010,Jan,71.5,66,2931636,2705380,226256,7.7
2010,Feb,71.5,66,2934157,2709231,224926,7.7
2010,Mar,71.5,66.1,2936270,2713397,222873,7.6
2010,Apr,71.5,66.1,2937670,2717445,220225,7.5
2010,May,71.5,66.2,2938435,2721066,217369,7.4
2010,Jun,71.4,66.2,2938805,2723778,215027,7.3
2010,Jul,71.4,66.2,2939250,2725306,213944,7.3
2010,Aug,71.4,66.2,2940138,2725971,214167,7.3
2010,Sep,71.3,66.1,2941269,2726480,214789,7.3
2010,Oct,71.3,66.1,2942146,2727688,214458,7.3
2010,Nov,71.3,66.1,2942245,2729932,212313,7.2
2010,Dec,71.2,66.1,2941809,2733191,208618,7.1
2011,Jan,71.1,66.2,2941435,2737393,204042,6.9
2011,Feb,71.1,66.3,2941838,2741696,200142,6.8
2011,Mar,71.1,66.3,2943124,2745212,197912,6.7
2011,Apr,71.1,66.3,2945087,2747838,197249,6.7
2011,May,71.1,66.3,2947426,2749971,197455,6.7
2011,Jun,71.1,66.4,2949387,2752143,197244,6.7
2011,Jul,71.1,66.4,2950563,2755094,195469,6.6
2011,Aug,71,66.4,2950646,2758898,191748,6.5
2011,Sep,70.9,66.5,2949489,2762924,186565,6.3
2011,Oct,70.8,66.5,2947613,2766525,181088,6.1
2011,Nov,70.8,66.5,2945429,2769210,176219,6
2011,Dec,70.7,66.5,2943191,2770778,172413,5.9
2012,Jan,70.6,66.5,2941312,2771438,169874,5.8
2012,Feb,70.5,66.5,2940126,2771941,168185,5.7
2012,Mar,70.4,66.4,2939631,2772639,166992,5.7
2012,Apr,70.4,66.4,2939742,2773408,166334,5.7
2012,May,70.4,66.4,2940579,2774614,165965,5.6
2012,Jun,70.4,66.4,2942474,2776729,165745,5.6
2012,Jul,70.4,66.4,2945136,2779732,165404,5.6
2012,Aug,70.4,66.5,2948475,2783485,164990,5.6
2012,Sep,70.4,66.5,2952420,2787876,164544,5.6
2012,Oct,70.5,66.6,2955833,2792315,163518,5.5
2012,Nov,70.5,66.6,2958006,2796171,161835,5.5
2012,Dec,70.4,66.6,2958803,2799077,159726,5.4
2013,Jan,70.4,66.6,2958448,2801058,157390,5.3
2013,Feb,70.3,66.6,2957536,2802512,155024,5.2
2013,Mar,70.3,66.6,2956696,2803957,152739,5.2
2013,Apr,70.2,66.7,2956563,2805906,150657,5.1
2013,May,70.2,66.7,2957110,2808169,148941,5
2013,Jun,70.2,66.7,2957938,2810445,147493,5
2013,Jul,70.1,66.7,2958811,2812690,146121,4.9
2013,Aug,70.1,66.7,2959293,2814962,144331,4.9
2013,Sep,70,66.7,2959346,2817257,142089,4.8
2013,Oct,70,66.7,2959868,2819676,140192,4.7
2013,Nov,70,66.7,2961337,2822308,139029,4.7
2013,Dec,70,66.7,2963292,2825014,138278,4.7
2014,Jan,70,66.7,2964752,2827317,137435,4.6
2014,Feb,70,66.8,2966238,2830253,135985,4.6
2014,Mar,70,66.8,2967430,2833677,133753,4.5
2014,Apr,69.9,66.9,2968228,2837486,130742,4.4
2014,May,69.9,66.9,2968773,2841721,127052,4.3
2014,Jun,69.9,67,2969723,2846504,123219,4.1
2014,Jul,69.9,67.1,2971460,2851481,119979,4
2014,Aug,69.9,67.1,2974054,2856280,117774,4
2014,Sep,69.9,67.2,2977012,2860581,116431,3.9
2014,Oct,69.9,67.2,2979545,2864148,115397,3.9
2014,Nov,69.9,67.2,2981152,2867002,114150,3.8
2014,Dec,69.9,67.3,2982491,2869598,112893,3.8
2015,Jan,70,67.3,2986322,2874200,112122,3.8
2015,Feb,70,67.4,2988962,2877096,111866,3.7
2015,Mar,70.1,67.4,2992271,2880260,112011,3.7
2015,Apr,70.1,67.5,2995715,2883633,112082,3.7
2015,May,70.1,67.5,2998720,2886844,111876,3.7
2015,Jun,70.1,67.5,3000794,2889448,111346,3.7
2015,Jul,70.1,67.5,3001995,2891466,110529,3.7
2015,Aug,70.1,67.5,3002926,2893249,109677,3.7
2015,Sep,70.1,67.5,3004387,2895400,108987,3.6
2015,Oct,70.1,67.5,3007353,2898465,108888,3.6
2015,Nov,70.1,67.6,3012066,2902407,109659,3.6
2015,Dec,70.2,67.6,3017428,2906659,110769,3.7
2016,Jan,70.3,67.7,3022094,2910450,111644,3.7
2016,Feb,70.3,67.7,3025460,2913180,112280,3.7
2016,Mar,70.3,67.7,3027550,2914689,112861,3.7
2016,Apr,70.3,67.7,3029031,2915312,113719,3.8
2016,May,70.3,67.6,3030768,2915661,115107,3.8
2016,Jun,70.3,67.6,3033097,2916186,116911,3.9
2016,Jul,70.3,67.6,3036017,2917152,118865,3.9
2016,Aug,70.3,67.5,3039275,2918624,120651,4
2016,Sep,70.3,67.5,3042451,2920504,121947,4
2016,Oct,70.3,67.5,3044793,2922732,122061,4
2016,Nov,70.3,67.5,3046156,2925607,120549,4
2016,Dec,70.3,67.6,3047127,2929230,117897,3.9
2017,Jan,70.3,67.6,3048278,2933511,114767,3.8
2017,Feb,70.3,67.7,3049745,2938220,111525,3.7
2017,Mar,70.3,67.8,3051441,2942677,108764,3.6
2017,Apr,70.3,67.8,3053567,2946664,106903,3.5
2017,May,70.3,67.8,3055914,2950324,105590,3.5
2017,Jun,70.3,67.9,3058239,2953742,104497,3.4
2017,Jul,70.3,67.9,3060454,2956931,103523,3.4
2017,Aug,70.2,67.9,3061889,2959715,102174,3.3
2017,Sep,70.2,67.9,3062333,2962056,100277,3.3
2017,Oct,70.1,67.9,3062047,2964049,97998,3.2
2017,Nov,70.1,67.9,3061481,2965577,95904,3.1
2017,Dec,70,67.9,3061162,2966934,94228,3.1
2018,Jan,70,67.9,3061622,2968564,93058,3
2018,Feb,70,67.9,3063130,2970767,92363,3
2018,Mar,70,67.9,3065197,2973525,91672,3
2018,Apr,70,67.9,3066759,2976186,90573,3
2018,May,70,67.9,3067566,2978174,89392,2.9
2018,Jun,69.9,67.9,3067978,2979644,88334,2.9
2018,Jul,69.9,67.9,3068467,2981142,87325,2.8
2018,Aug,69.9,67.9,3070293,2983142,87151,2.8
2018,Sep,69.9,67.9,3073942,2985670,88272,2.9
2018,Oct,70,67.9,3079042,2988502,90540,2.9
2018,Nov,70,67.9,3084727,2991361,93366,3
2018,Dec,70.1,67.9,3089750,2993761,95989,3.1
2019,Jan,70.2,67.9,3093308,2995382,97926,3.2
2019,Feb,70.2,67.9,3095337,2996333,99004,3.2
2019,Mar,70.2,67.9,3096730,2997265,99465,3.2
2019,Apr,70.2,67.9,3098456,2999023,99433,3.2
2019,May,70.2,67.9,3101106,3002006,99100,3.2
2019,Jun,70.2,68,3105019,3006047,98972,3.2
2019,Jul,70.3,68,3110509,3011020,99489,3.2
2019,Aug,70.4,68.1,3115785,3015505,100280,3.2
2019,Sep,70.4,68.1,3120459,3019383,101076,3.2
2019,Oct,70.4,68.1,3123561,3021790,101771,3.3
2019,Nov,70.4,68.1,3123569,3021641,101928,3.3
2019,Dec,70.3,68,3123024,3021131,101893,3.3
2020,Jan,70.3,68.1,3122744,3023966,98778,3.2
2020,Feb,70.2,68.1,3121329,3025204,96125,3.1
2020,Mar,69.6,67.6,3094328,3005502,88826,2.9
2020,Apr,68.9,62.9,3066464,2799493,266971,8.7
2020,May,68.9,62.1,3069944,2766978,302966,9.9
2020,Jun,69.9,63.9,3114109,2846131,267978,8.6
2020,Jul,69.4,64.1,3093304,2856757,236547,7.6
2020,Aug,69.7,64.6,3111751,2881120,230631,7.4
2020,Sep,68.4,64.3,3055452,2872689,182763,6
