Year,Period,labor force participation rate,employment-population ratio,labor force,employment,unemployment,unemployment rate
1976,Jan,60.3,56.7,2088814,1963951,124863,6
1976,Feb,60.2,56.6,2087305,1962686,124619,6
1976,Mar,60.1,56.5,2087996,1963435,124561,6
1976,Apr,60.3,56.7,2095946,1970155,125791,6
1976,May,60.5,56.9,2107426,1979762,127664,6.1
1976,Jun,60.8,57.1,2120593,1990642,129951,6.1
1976,Jul,61.1,57.3,2132641,2000098,132543,6.2
1976,Aug,61.3,57.5,2142316,2006941,135375,6.3
1976,Sep,61.5,57.5,2150007,2011687,138320,6.4
1976,Oct,61.6,57.5,2155677,2014721,140956,6.5
1976,Nov,61.6,57.6,2159828,2017377,142451,6.6
1976,Dec,61.7,57.6,2163567,2021522,142045,6.6
1977,Jan,61.7,57.7,2169076,2028693,140383,6.5
1977,Feb,61.9,58,2177301,2038976,138325,6.4
1977,Mar,62.1,58.2,2187601,2050903,136698,6.2
1977,Apr,62.4,58.5,2199105,2063173,135932,6.2
1977,May,62.6,58.8,2210554,2074618,135936,6.1
1977,Jun,62.9,59,2220906,2084446,136460,6.1
1977,Jul,63,59.2,2229405,2092990,136415,6.1
1977,Aug,63.1,59.3,2236129,2101127,135002,6
1977,Sep,63.2,59.5,2241727,2109220,132507,5.9
1977,Oct,63.3,59.6,2246311,2116560,129751,5.8
1977,Nov,63.3,59.7,2250156,2122347,127809,5.7
1977,Dec,63.3,59.8,2253009,2126018,126991,5.6
1978,Jan,63.3,59.8,2254557,2128489,126068,5.6
1978,Feb,63.3,59.8,2255062,2130805,124257,5.5
1978,Mar,63.2,59.8,2254714,2133235,121479,5.4
1978,Apr,63.1,59.8,2253329,2135548,117781,5.2
1978,May,62.9,59.8,2251359,2137812,113547,5
1978,Jun,62.8,59.8,2249517,2140258,109259,4.9
1978,Jul,62.7,59.8,2248702,2142742,105960,4.7
1978,Aug,62.7,59.8,2249466,2145593,103873,4.6
1978,Sep,62.7,59.9,2252126,2149837,102289,4.5
1978,Oct,62.8,60,2257129,2156490,100639,4.5
1978,Nov,62.9,60.2,2263761,2164895,98866,4.4
1978,Dec,63.1,60.3,2270000,2172552,97448,4.3
1979,Jan,63.1,60.4,2273989,2176998,96991,4.3
1979,Feb,63.1,60.4,2274965,2177792,97173,4.3
1979,Mar,63,60.3,2273843,2175946,97897,4.3
1979,Apr,62.9,60.2,2272439,2172734,99705,4.4
1979,May,62.9,60,2272418,2169808,102610,4.5
1979,Jun,62.9,59.9,2274045,2167748,106297,4.7
1979,Jul,62.9,59.8,2277316,2167139,110177,4.8
1979,Aug,63,59.8,2282041,2167871,114170,5
1979,Sep,63,59.8,2287359,2168934,118425,5.2
1979,Oct,63.1,59.7,2292215,2169529,122686,5.4
1979,Nov,63.1,59.6,2295672,2169229,126443,5.5
1979,Dec,63.1,59.5,2297685,2167641,130044,5.7
1980,Jan,63.1,59.4,2298482,2163901,134581,5.9
1980,Feb,63,59.1,2298451,2157488,140963,6.1
1980,Mar,62.9,58.8,2298603,2149178,149425,6.5
1980,Apr,62.9,58.6,2299462,2140626,158836,6.9
1980,May,62.9,58.3,2301261,2133304,167957,7.3
1980,Jun,62.9,58.2,2304536,2128940,175596,7.6
1980,Jul,63,58.1,2308303,2127957,180346,7.8
1980,Aug,63.1,58.1,2311276,2129526,181750,7.9
1980,Sep,63.1,58.2,2313114,2132473,180641,7.8
1980,Oct,63,58.2,2313757,2135311,178446,7.7
1980,Nov,63,58.2,2314553,2137930,176623,7.6
1980,Dec,63.1,58.3,2317589,2141710,175879,7.6
1981,Jan,63.2,58.4,2322791,2146879,175912,7.6
1981,Feb,63.3,58.5,2328244,2152344,175900,7.6
1981,Mar,63.3,58.6,2331836,2157213,174623,7.5
1981,Apr,63.3,58.6,2331986,2160029,171957,7.4
1981,May,63.2,58.6,2328680,2159674,169006,7.3
1981,Jun,63,58.5,2323564,2156426,167138,7.2
1981,Jul,62.8,58.3,2318620,2150785,167835,7.2
1981,Aug,62.7,58.1,2315111,2143634,171477,7.4
1981,Sep,62.7,57.9,2313582,2136244,177338,7.7
1981,Oct,62.7,57.7,2314213,2129745,184468,8
1981,Nov,62.7,57.5,2315399,2124132,191267,8.3
1981,Dec,62.7,57.4,2315844,2119743,196101,8.5
1982,Jan,62.7,57.3,2316002,2117621,198381,8.6
1982,Feb,62.7,57.3,2317147,2117948,199199,8.6
1982,Mar,62.7,57.3,2319543,2119654,199889,8.6
1982,Apr,62.8,57.4,2323259,2122019,201240,8.7
1982,May,62.9,57.4,2327343,2123934,203409,8.7
1982,Jun,63,57.4,2330058,2123479,206579,8.9
1982,Jul,63,57.3,2331250,2119916,211334,9.1
1982,Aug,63,57.1,2331408,2113765,217643,9.3
1982,Sep,62.9,56.8,2330672,2106027,224645,9.6
1982,Oct,62.8,56.6,2329435,2098105,231330,9.9
1982,Nov,62.8,56.4,2328802,2091659,237143,10.2
1982,Dec,62.7,56.2,2328723,2087086,241637,10.4
1983,Jan,62.7,56.1,2329296,2084532,244764,10.5
1983,Feb,62.7,56.1,2331375,2084823,246552,10.6
1983,Mar,62.8,56.1,2335107,2087997,247110,10.6
1983,Apr,62.9,56.3,2340785,2094103,246682,10.5
1983,May,63,56.5,2347924,2102799,245125,10.4
1983,Jun,63.2,56.7,2355634,2113558,242076,10.3
1983,Jul,63.4,57,2363021,2125921,237100,10
1983,Aug,63.5,57.3,2369173,2138476,230697,9.7
1983,Sep,63.6,57.6,2373984,2150064,223920,9.4
1983,Oct,63.6,57.8,2377682,2160352,217330,9.1
1983,Nov,63.7,58,2380480,2169106,211374,8.9
1983,Dec,63.7,58.2,2382938,2176781,206157,8.7
1984,Jan,63.7,58.4,2385344,2184650,200694,8.4
1984,Feb,63.7,58.5,2387107,2193144,193963,8.1
1984,Mar,63.7,58.7,2387850,2201498,186352,7.8
1984,Apr,63.6,58.9,2387059,2208445,178614,7.5
1984,May,63.5,59,2385116,2213621,171495,7.2
1984,Jun,63.4,59,2382582,2217079,165503,6.9
1984,Jul,63.3,59,2380088,2219053,161035,6.8
1984,Aug,63.3,59.1,2379336,2220824,158512,6.7
1984,Sep,63.3,59.1,2381486,2223642,157844,6.6
1984,Oct,63.4,59.2,2387171,2228705,158466,6.6
1984,Nov,63.7,59.4,2396710,2237003,159707,6.7
1984,Dec,64,59.7,2409121,2247884,161237,6.7
1985,Jan,64.3,60,2422015,2258789,163226,6.7
1985,Feb,64.6,60.2,2432878,2267609,165269,6.8
1985,Mar,64.7,60.3,2440301,2274002,166299,6.8
1985,Apr,64.8,60.4,2444448,2278602,165846,6.8
1985,May,64.9,60.5,2446992,2282585,164407,6.7
1985,Jun,64.9,60.6,2450403,2287763,162640,6.6
1985,Jul,65.1,60.8,2456285,2295261,161024,6.6
1985,Aug,65.2,61,2464868,2305744,159124,6.5
1985,Sep,65.4,61.3,2475387,2318381,157006,6.3
1985,Oct,65.7,61.6,2486171,2330929,155242,6.2
1985,Nov,65.8,61.8,2495067,2341297,153770,6.2
1985,Dec,65.9,61.9,2500931,2348419,152512,6.1
1986,Jan,65.9,61.9,2504672,2352727,151945,6.1
1986,Feb,65.9,61.9,2508546,2355882,152664,6.1
1986,Mar,66,62,2514032,2359477,154555,6.1
1986,Apr,66.1,62,2521488,2364414,157074,6.2
1986,May,66.3,62.1,2530161,2370549,159612,6.3
1986,Jun,66.5,62.2,2538899,2377254,161645,6.4
1986,Jul,66.6,62.3,2546201,2383756,162445,6.4
1986,Aug,66.6,62.4,2551008,2388993,162015,6.4
1986,Sep,66.6,62.4,2553464,2392534,160930,6.3
1986,Oct,66.6,62.4,2554476,2394716,159760,6.3
1986,Nov,66.6,62.4,2555217,2395568,159649,6.2
1986,Dec,66.6,62.4,2557702,2396542,161160,6.3
1987,Jan,66.6,62.4,2562312,2398743,163569,6.4
1987,Feb,66.7,62.4,2568057,2402010,166047,6.5
1987,Mar,66.8,62.4,2574579,2406356,168223,6.5
1987,Apr,66.9,62.5,2580867,2411616,169251,6.6
1987,May,67,62.6,2585891,2417322,168569,6.5
1987,Jun,67,62.7,2589334,2422620,166714,6.4
1987,Jul,67,62.7,2591288,2426832,164456,6.3
1987,Aug,66.9,62.7,2591510,2429601,161909,6.2
1987,Sep,66.8,62.7,2589912,2431484,158428,6.1
1987,Oct,66.7,62.7,2586516,2432708,153808,5.9
1987,Nov,66.6,62.7,2582189,2433878,148311,5.7
1987,Dec,66.4,62.7,2577749,2434637,143112,5.6
1988,Jan,66.3,62.7,2574227,2434597,139630,5.4
1988,Feb,66.2,62.6,2572940,2434307,138633,5.4
1988,Mar,66.2,62.6,2574017,2433786,140231,5.4
1988,Apr,66.2,62.5,2577151,2433201,143950,5.6
1988,May,66.3,62.5,2581231,2432954,148277,5.7
1988,Jun,66.3,62.4,2584787,2433353,151434,5.9
1988,Jul,66.3,62.4,2587303,2434437,152866,5.9
1988,Aug,66.4,62.4,2589313,2436132,153181,5.9
1988,Sep,66.4,62.5,2591456,2438362,153094,5.9
1988,Oct,66.5,62.5,2593977,2441259,152718,5.9
1988,Nov,66.5,62.6,2596668,2444753,151915,5.9
1988,Dec,66.5,62.7,2598449,2448309,150140,5.8
1989,Jan,66.6,62.8,2599161,2451725,147436,5.7
1989,Feb,66.5,62.8,2599001,2454335,144666,5.6
1989,Mar,66.5,62.9,2598867,2456651,142216,5.5
1989,Apr,66.5,62.9,2599763,2459090,140673,5.4
1989,May,66.6,63,2602159,2461581,140578,5.4
1989,Jun,66.7,63,2606209,2464270,141939,5.4
1989,Jul,66.8,63.1,2611070,2466967,144103,5.5
1989,Aug,66.9,63.1,2615941,2469865,146076,5.6
1989,Sep,67,63.2,2620615,2473255,147360,5.6
1989,Oct,67.1,63.3,2626023,2478057,147966,5.6
1989,Nov,67.2,63.5,2632445,2484325,148120,5.6
1989,Dec,67.4,63.6,2639876,2491836,148040,5.6
1990,Jan,67.9,64,2603785,2456764,147021,5.6
1990,Feb,67.6,63.8,2596432,2452145,144287,5.6
1990,Mar,67.5,63.8,2595984,2455164,140820,5.4
1990,Apr,67.4,63.8,2596927,2458587,138340,5.3
1990,May,67.4,63.8,2599175,2461137,138038,5.3
1990,Jun,67.4,63.8,2603032,2462472,140560,5.4
1990,Jul,67.5,63.7,2609375,2463473,145902,5.6
1990,Aug,67.7,63.7,2617968,2464575,153393,5.9
1990,Sep,67.9,63.7,2626829,2465050,161779,6.2
1990,Oct,68,63.6,2634068,2464216,169852,6.4
1990,Nov,68.1,63.5,2639103,2462940,176163,6.7
1990,Dec,68.1,63.5,2642226,2461990,180236,6.8
1991,Jan,68.1,63.4,2644179,2461233,182946,6.9
1991,Feb,68.1,63.4,2646242,2461498,184744,7
1991,Mar,68.2,63.4,2647795,2462732,185063,7
1991,Apr,68.1,63.4,2648247,2464755,183492,6.9
1991,May,68.1,63.5,2648106,2467527,180579,6.8
1991,Jun,68.1,63.5,2647972,2471050,176922,6.7
1991,Jul,68,63.6,2647504,2474577,172927,6.5
1991,Aug,67.9,63.6,2646718,2477407,169311,6.4
1991,Sep,67.9,63.6,2646078,2479565,166513,6.3
1991,Oct,67.8,63.6,2645072,2480606,164466,6.2
1991,Nov,67.7,63.5,2643769,2480588,163181,6.2
1991,Dec,67.7,63.5,2642613,2480140,162473,6.1
1992,Jan,67.6,63.5,2642661,2480350,162311,6.1
1992,Feb,67.7,63.5,2644853,2481737,163116,6.2
1992,Mar,67.8,63.5,2649854,2485072,164782,6.2
1992,Apr,67.9,63.6,2656498,2489768,166730,6.3
1992,May,68,63.7,2661559,2493633,167926,6.3
1992,Jun,68,63.7,2662863,2495180,167683,6.3
1992,Jul,67.9,63.6,2660334,2494157,166177,6.2
1992,Aug,67.6,63.5,2654917,2491135,163782,6.2
1992,Sep,67.4,63.3,2648701,2487104,161597,6.1
1992,Oct,67.2,63.2,2644572,2483731,160841,6.1
1992,Nov,67.2,63,2643329,2481399,161930,6.1
1992,Dec,67.1,63,2644874,2480553,164321,6.2
1993,Jan,67.2,62.9,2649190,2482005,167185,6.3
1993,Feb,67.3,63,2655410,2485646,169764,6.4
1993,Mar,67.4,63.1,2662887,2491263,171624,6.4
1993,Apr,67.6,63.2,2670797,2498493,172304,6.5
1993,May,67.7,63.4,2678431,2506339,172092,6.4
1993,Jun,67.8,63.5,2685369,2513899,171470,6.4
1993,Jul,67.9,63.6,2690734,2520523,170211,6.3
1993,Aug,67.9,63.7,2694792,2526545,168247,6.2
1993,Sep,67.9,63.8,2698733,2533124,165609,6.1
1993,Oct,68,63.9,2703326,2540778,162548,6
1993,Nov,68.1,64,2709142,2549310,159832,5.9
1993,Dec,68.2,64.2,2715912,2558600,157312,5.8
1994,Jan,68.3,64.4,2722062,2567941,154121,5.7
1994,Feb,68.3,64.6,2726122,2576413,149709,5.5
1994,Mar,68.3,64.7,2728415,2583767,144648,5.3
1994,Apr,68.3,64.8,2730721,2590922,139799,5.1
1994,May,68.4,65,2735659,2599873,135786,5
1994,Jun,68.6,65.2,2745188,2611935,133253,4.9
1994,Jul,68.9,65.5,2760339,2627512,132827,4.8
1994,Aug,69.3,65.9,2779832,2645630,134202,4.8
1994,Sep,69.7,66.3,2800867,2664480,136387,4.9
1994,Oct,70.2,66.7,2820601,2682504,138097,4.9
1994,Nov,70.5,67.1,2837376,2698750,138626,4.9
1994,Dec,70.8,67.3,2849956,2711449,138507,4.9
1995,Jan,70.9,67.5,2857777,2719304,138473,4.8
1995,Feb,71,67.5,2862043,2723224,138819,4.9
1995,Mar,71,67.5,2863795,2724395,139400,4.9
1995,Apr,70.9,67.4,2863976,2724082,139894,4.9
1995,May,70.8,67.4,2864118,2724036,140082,4.9
1995,Jun,70.8,67.4,2864649,2725269,139380,4.9
1995,Jul,70.7,67.4,2865249,2727889,137360,4.8
1995,Aug,70.7,67.4,2865384,2731017,134367,4.7
1995,Sep,70.6,67.4,2864907,2733807,131100,4.6
1995,Oct,70.5,67.4,2864254,2735770,128484,4.5
1995,Nov,70.5,67.3,2864012,2736952,127060,4.4
1995,Dec,70.4,67.3,2865492,2738085,127407,4.4
1996,Jan,70.5,67.3,2870075,2740465,129610,4.5
1996,Feb,70.6,67.4,2877934,2744785,133149,4.6
1996,Mar,70.8,67.5,2888108,2751076,137032,4.7
1996,Apr,71,67.6,2898656,2758571,140085,4.8
1996,May,71.2,67.7,2907481,2766153,141328,4.9
1996,Jun,71.3,67.8,2914024,2773044,140980,4.8
1996,Jul,71.3,67.9,2918732,2778768,139964,4.8
1996,Aug,71.3,67.9,2922489,2783240,139249,4.8
1996,Sep,71.3,67.9,2925353,2785909,139444,4.8
1996,Oct,71.3,67.9,2926996,2786498,140498,4.8
1996,Nov,71.2,67.8,2927371,2785978,141393,4.8
1996,Dec,71.2,67.7,2926639,2785811,140828,4.8
1997,Jan,71.1,67.7,2925048,2786753,138295,4.7
1997,Feb,71,67.7,2922991,2788926,134065,4.6
1997,Mar,70.9,67.8,2921303,2792583,128720,4.4
1997,Apr,70.8,67.8,2921364,2797333,124031,4.2
1997,May,70.8,67.9,2923165,2801579,121586,4.2
1997,Jun,70.8,67.9,2926115,2804521,121594,4.2
1997,Jul,70.9,67.9,2929603,2806503,123100,4.2
1997,Aug,70.9,67.9,2932760,2807624,125136,4.3
1997,Sep,70.9,67.8,2934800,2807969,126831,4.3
1997,Oct,70.8,67.8,2935411,2807386,128025,4.4
1997,Nov,70.8,67.7,2934213,2805361,128852,4.4
1997,Dec,70.7,67.5,2931695,2802288,129407,4.4
1998,Jan,70.5,67.4,2928517,2798877,129640,4.4
1998,Feb,70.4,67.3,2925576,2795852,129724,4.4
1998,Mar,70.4,67.2,2923262,2793371,129891,4.4
1998,Apr,70.3,67.2,2921529,2792073,129456,4.4
1998,May,70.2,67.1,2920425,2792463,127962,4.4
1998,Jun,70.1,67.1,2919389,2793661,125728,4.3
1998,Jul,70.1,67.1,2917924,2794642,123282,4.2
1998,Aug,70,67.1,2915958,2795666,120292,4.1
1998,Sep,69.8,67,2913501,2797070,116431,4
1998,Oct,69.7,67,2910289,2798989,111300,3.8
1998,Nov,69.5,67,2906231,2800838,105393,3.6
1998,Dec,69.4,67,2901627,2801801,99826,3.4
1999,Jan,69.2,66.9,2897463,2801777,95686,3.3
1999,Feb,69.1,66.9,2895010,2801049,93961,3.2
1999,Mar,69.1,66.8,2894984,2800159,94825,3.3
1999,Apr,69.1,66.8,2897369,2799582,97787,3.4
1999,May,69.1,66.7,2900852,2799785,101067,3.5
1999,Jun,69.2,66.7,2904259,2801598,102661,3.5
1999,Jul,69.2,66.8,2906797,2804967,101830,3.5
1999,Aug,69.2,66.8,2908366,2809518,98848,3.4
1999,Sep,69.1,66.9,2909979,2815134,94845,3.3
1999,Oct,69.1,67,2912857,2821421,91436,3.1
1999,Nov,69.2,67.1,2918221,2828507,89714,3.1
1999,Dec,69.3,67.2,2925940,2835825,90115,3.1
2000,Jan,69.5,67.3,2934571,2842278,92293,3.1
2000,Feb,69.6,67.4,2941758,2847106,94652,3.2
2000,Mar,69.7,67.4,2946114,2849858,96256,3.3
2000,Apr,69.8,67.5,2947684,2850551,97133,3.3
2000,May,69.7,67.4,2948096,2849864,98232,3.3
2000,Jun,69.7,67.3,2948918,2848636,100282,3.4
2000,Jul,69.7,67.3,2951489,2848241,103248,3.5
2000,Aug,69.8,67.2,2957543,2850080,107463,3.6
2000,Sep,69.9,67.3,2967517,2854570,112947,3.8
2000,Oct,70.2,67.4,2980523,2861498,119025,4
2000,Nov,70.5,67.5,2994421,2869469,124952,4.2
2000,Dec,70.7,67.6,3006359,2876691,129668,4.3
2001,Jan,70.8,67.7,3014132,2881677,132455,4.4
2001,Feb,70.9,67.7,3017174,2883711,133463,4.4
2001,Mar,70.8,67.7,3015806,2882851,132955,4.4
2001,Apr,70.6,67.5,3010928,2879504,131424,4.4
2001,May,70.4,67.4,3004613,2874741,129872,4.3
2001,Jun,70.2,67.2,2998970,2869192,129778,4.3
2001,Jul,70.1,67,2995352,2863258,132094,4.4
2001,Aug,70,66.8,2992959,2856413,136546,4.6
2001,Sep,69.9,66.5,2991029,2848999,142030,4.7
2001,Oct,69.8,66.3,2989611,2842120,147491,4.9
2001,Nov,69.7,66.2,2988835,2836510,152325,5.1
2001,Dec,69.7,66,2989293,2833028,156265,5.2
2002,Jan,69.7,66,2991163,2831893,159270,5.3
2002,Feb,69.7,65.9,2993668,2832132,161536,5.4
2002,Mar,69.7,65.9,2995963,2832671,163292,5.5
2002,Apr,69.7,65.9,2998049,2833660,164389,5.5
2002,May,69.7,65.9,2999985,2835407,164578,5.5
2002,Jun,69.7,65.9,3001649,2838103,163546,5.4
2002,Jul,69.6,65.9,3002861,2841131,161730,5.4
2002,Aug,69.6,65.9,3004047,2844067,159980,5.3
2002,Sep,69.6,65.9,3005277,2846364,158913,5.3
2002,Oct,69.5,65.9,3005779,2847205,158574,5.3
2002,Nov,69.5,65.8,3005665,2847157,158508,5.3
2002,Dec,69.4,65.8,3005695,2846899,158796,5.3
2003,Jan,69.4,65.7,3007409,2847349,160060,5.3
2003,Feb,69.5,65.8,3011671,2849311,162360,5.4
2003,Mar,69.6,65.8,3017672,2852206,165466,5.5
2003,Apr,69.7,65.8,3023438,2854149,169289,5.6
2003,May,69.8,65.8,3027131,2853732,173399,5.7
2003,Jun,69.7,65.7,3028413,2851600,176813,5.8
2003,Jul,69.7,65.6,3027432,2849182,178250,5.9
2003,Aug,69.5,65.5,3024684,2847559,177125,5.9
2003,Sep,69.4,65.4,3021376,2847476,173900,5.8
2003,Oct,69.3,65.4,3018992,2849005,169987,5.6
2003,Nov,69.2,65.4,3017926,2851100,166826,5.5
2003,Dec,69.1,65.3,3017361,2852266,165095,5.5
2004,Jan,69.1,65.3,3016161,2851363,164798,5.5
2004,Feb,69,65.2,3014413,2848329,166084,5.5
2004,Mar,68.9,65,3013464,2844442,169022,5.6
2004,Apr,68.9,64.9,3013728,2840895,172833,5.7
2004,May,68.8,64.8,3014844,2838238,176606,5.9
2004,Jun,68.8,64.7,3016228,2836545,179683,6
2004,Jul,68.8,64.6,3017381,2835598,181783,6
2004,Aug,68.7,64.6,3017707,2835041,182666,6.1
2004,Sep,68.6,64.5,3016752,2834285,182467,6
2004,Oct,68.5,64.4,3014457,2832887,181570,6
2004,Nov,68.4,64.3,3011421,2831079,180342,6
2004,Dec,68.3,64.2,3009143,2829799,179344,6
2005,Jan,68.2,64.1,3008277,2829722,178555,5.9
2005,Feb,68.1,64.1,3008489,2830973,177516,5.9
2005,Mar,68.1,64.1,3009086,2833864,175222,5.8
2005,Apr,68.1,64.2,3009823,2838606,171217,5.7
2005,May,68,64.3,3010528,2844793,165735,5.5
2005,Jun,67.9,64.3,3010986,2850854,160132,5.3
2005,Jul,67.9,64.4,3010963,2855153,155810,5.2
2005,Aug,67.8,64.3,3010191,2857025,153166,5.1
2005,Sep,67.7,64.3,3008871,2856782,152089,5.1
2005,Oct,67.5,64.1,3007525,2855742,151783,5
2005,Nov,67.5,64.1,3006793,2855154,151639,5
2005,Dec,67.4,64,3006784,2855836,150948,5
2006,Jan,67.3,64,3007652,2858395,149257,5
2006,Feb,67.3,64,3009391,2862614,146777,4.9
2006,Mar,67.3,64.1,3012023,2867493,144530,4.8
2006,Apr,67.4,64.1,3015514,2871997,143517,4.8
2006,May,67.4,64.2,3019700,2875895,143805,4.8
2006,Jun,67.4,64.2,3024309,2879381,144928,4.8
2006,Jul,67.5,64.2,3029648,2883333,146315,4.8
2006,Aug,67.6,64.3,3036125,2888089,148036,4.9
2006,Sep,67.7,64.3,3042858,2893168,149690,4.9
2006,Oct,67.7,64.4,3048686,2898195,150491,4.9
2006,Nov,67.7,64.4,3052473,2902340,150133,4.9
2006,Dec,67.7,64.4,3053169,2904393,148776,4.9
2007,Jan,67.6,64.3,3050962,2903681,147281,4.8
2007,Feb,67.5,64.2,3046883,2900511,146372,4.8
2007,Mar,67.3,64.1,3041673,2895339,146334,4.8
2007,Apr,67.1,63.9,3036487,2889220,147267,4.8
2007,May,67,63.7,3032549,2883093,149456,4.9
2007,Jun,66.9,63.5,3030140,2877640,152500,5
2007,Jul,66.8,63.4,3029230,2873272,155958,5.1
2007,Aug,66.8,63.2,3029620,2870257,159363,5.3
2007,Sep,66.7,63.2,3030588,2868724,161864,5.3
2007,Oct,66.7,63.1,3030953,2867694,163259,5.4
2007,Nov,66.6,63,3029895,2866543,163352,5.4
2007,Dec,66.5,62.9,3027711,2865167,162544,5.4
2008,Jan,66.4,62.8,3024815,2863111,161704,5.3
2008,Feb,66.3,62.7,3021976,2860429,161547,5.3
2008,Mar,66.2,62.6,3020507,2857380,163127,5.4
2008,Apr,66.1,62.5,3020906,2853952,166954,5.5
2008,May,66.1,62.4,3022958,2850306,172652,5.7
2008,Jun,66.2,62.2,3026250,2846846,179404,5.9
2008,Jul,66.2,62.1,3029648,2843482,186166,6.1
2008,Aug,66.2,62,3032357,2839766,192591,6.4
2008,Sep,66.2,61.8,3034841,2834975,199866,6.6
2008,Oct,66.2,61.6,3037807,2828474,209333,6.9
2008,Nov,66.2,61.4,3041096,2820018,221078,7.3
2008,Dec,66.3,61.2,3044195,2809972,234223,7.7
2009,Jan,66.3,60.9,3047000,2799327,247673,8.1
2009,Feb,66.3,60.7,3049995,2789506,260489,8.5
2009,Mar,66.4,60.5,3053342,2782239,271103,8.9
2009,Apr,66.4,60.4,3056796,2778045,278751,9.1
2009,May,66.4,60.3,3059216,2775427,283789,9.3
2009,Jun,66.4,60.2,3059867,2772659,287208,9.4
2009,Jul,66.3,60,3058087,2768238,289849,9.5
2009,Aug,66.2,59.9,3053579,2761739,291840,9.6
2009,Sep,66,59.7,3047344,2754295,293049,9.6
2009,Oct,65.8,59.5,3040995,2747440,293555,9.7
2009,Nov,65.7,59.3,3037488,2743050,294438,9.7
2009,Dec,65.7,59.3,3038815,2742566,296249,9.7
2010,Jan,65.8,59.3,3044035,2746214,297821,9.8
2010,Feb,65.9,59.4,3050406,2752092,298314,9.8
2010,Mar,66,59.5,3055657,2758039,297618,9.7
2010,Apr,66.2,59.8,3058868,2763038,295830,9.7
2010,May,66.2,59.9,3059887,2766767,293120,9.6
2010,Jun,66.2,59.9,3059038,2768613,290425,9.5
2010,Jul,66.1,59.8,3057515,2768607,288908,9.4
2010,Aug,66,59.8,3056769,2767659,289110,9.5
2010,Sep,66,59.7,3056905,2766458,290447,9.5
2010,Oct,66,59.7,3057770,2766309,291461,9.5
2010,Nov,66,59.7,3058401,2767747,290654,9.5
2010,Dec,65.9,59.7,3057994,2770483,287511,9.4
2011,Jan,65.9,59.8,3057319,2774185,283134,9.3
2011,Feb,65.9,59.9,3056187,2778184,278003,9.1
2011,Mar,65.8,59.9,3054008,2781464,272544,8.9
2011,Apr,65.7,59.9,3050784,2783078,267706,8.8
2011,May,65.6,59.9,3047588,2783392,264196,8.7
2011,Jun,65.5,59.9,3045445,2783829,261616,8.6
2011,Jul,65.5,59.9,3044731,2785616,259115,8.5
2011,Aug,65.5,60,3044873,2789075,255798,8.4
2011,Sep,65.4,60,3044857,2794010,250847,8.2
2011,Oct,65.4,60.1,3044159,2799733,244426,8
2011,Nov,65.3,60.2,3042107,2804880,237227,7.8
2011,Dec,65.2,60.3,3038534,2808573,229961,7.6
2012,Jan,65.1,60.3,3033914,2810674,223240,7.4
2012,Feb,65,60.3,3029635,2811627,218008,7.2
2012,Mar,64.9,60.3,3026396,2811472,214924,7.1
2012,Apr,64.8,60.3,3023540,2810596,212944,7
2012,May,64.8,60.2,3021371,2810192,211179,7
2012,Jun,64.7,60.2,3020302,2811126,209176,6.9
2012,Jul,64.7,60.3,3020759,2813834,206925,6.9
2012,Aug,64.7,60.3,3023006,2817607,205399,6.8
2012,Sep,64.7,60.4,3026333,2820827,205506,6.8
2012,Oct,64.8,60.3,3028386,2821739,206647,6.8
2012,Nov,64.7,60.3,3027506,2819833,207673,6.9
2012,Dec,64.6,60.2,3023527,2815590,207937,6.9
2013,Jan,64.7,60.3,3028433,2820950,207483,6.9
2013,Feb,64.6,60.1,3022164,2815634,206530,6.8
2013,Mar,64.5,60.1,3018206,2812786,205420,6.8
2013,Apr,64.4,60.1,3018139,2813392,204747,6.8
2013,May,64.5,60.1,3020703,2816017,204686,6.8
2013,Jun,64.5,60.1,3023445,2818684,204761,6.8
2013,Jul,64.5,60.1,3024493,2820140,204353,6.8
2013,Aug,64.4,60.1,3022915,2820313,202602,6.7
2013,Sep,64.3,60.1,3020000,2820028,199972,6.6
2013,Oct,64.3,60.1,3018648,2820136,198512,6.6
2013,Nov,64.3,60.1,3020515,2821486,199029,6.6
2013,Dec,64.4,60.1,3025140,2824308,200832,6.6
2014,Jan,64.5,60.2,3030438,2827730,202708,6.7
2014,Feb,64.6,60.2,3035586,2832780,202806,6.7
2014,Mar,64.6,60.3,3039018,2838142,200876,6.6
2014,Apr,64.6,60.4,3040435,2843215,197220,6.5
2014,May,64.6,60.5,3040778,2848392,192386,6.3
2014,Jun,64.6,60.6,3041836,2854494,187342,6.2
2014,Jul,64.6,60.7,3044284,2861346,182938,6
2014,Aug,64.7,60.9,3048411,2868825,179586,5.9
2014,Sep,64.8,61,3053732,2876710,177022,5.8
2014,Oct,64.8,61.1,3058716,2884305,174411,5.7
2014,Nov,64.9,61.2,3062698,2890714,171984,5.6
2014,Dec,64.9,61.3,3066576,2895898,170678,5.6
2015,Jan,65,61.4,3070254,2899964,170290,5.5
2015,Feb,65.1,61.5,3074251,2903830,170421,5.5
2015,Mar,65.1,61.5,3077662,2907806,169856,5.5
2015,Apr,65.1,61.6,3079601,2912128,167473,5.4
2015,May,65.1,61.7,3079387,2916386,163001,5.3
2015,Jun,65,61.7,3077194,2919947,157247,5.1
2015,Jul,65,61.8,3074280,2922956,151324,4.9
2015,Aug,64.9,61.8,3071946,2925819,146127,4.8
2015,Sep,64.8,61.8,3070945,2929079,141866,4.6
2015,Oct,64.8,61.9,3072238,2933465,138773,4.5
2015,Nov,64.9,62,3075731,2938768,136963,4.5
2015,Dec,64.9,62.1,3079522,2943784,135738,4.4
2016,Jan,65,62.1,3082319,2947440,134879,4.4
2016,Feb,65,62.2,3083829,2949106,134723,4.4
2016,Mar,65,62.1,3084241,2948582,135659,4.4
2016,Apr,65,62.1,3084431,2946339,138092,4.5
2016,May,65,62,3085186,2943398,141788,4.6
2016,Jun,65,61.9,3086139,2940589,145550,4.7
2016,Jul,64.9,61.8,3086459,2938411,148048,4.8
2016,Aug,64.9,61.8,3085409,2936860,148549,4.8
2016,Sep,64.8,61.7,3082738,2935743,146995,4.8
2016,Oct,64.7,61.7,3078240,2934973,143267,4.7
2016,Nov,64.5,61.6,3072652,2935010,137642,4.5
2016,Dec,64.4,61.6,3067717,2936206,131511,4.3
2017,Jan,64.3,61.7,3064503,2938306,126197,4.1
2017,Feb,64.3,61.7,3062879,2941004,121875,4
2017,Mar,64.2,61.7,3062473,2943685,118788,3.9
2017,Apr,64.2,61.8,3063071,2946310,116761,3.8
2017,May,64.2,61.8,3064079,2948979,115100,3.8
2017,Jun,64.2,61.8,3064985,2951384,113601,3.7
2017,Jul,64.2,61.9,3065765,2953279,112486,3.7
2017,Aug,64.2,61.9,3065797,2954250,111547,3.6
2017,Sep,64.1,61.8,3064685,2954115,110570,3.6
2017,Oct,64.1,61.8,3062591,2953071,109520,3.6
2017,Nov,64,61.7,3059836,2951457,108379,3.5
2017,Dec,63.9,61.7,3056857,2950059,106798,3.5
2018,Jan,63.9,61.7,3054637,2949635,105002,3.4
2018,Feb,63.8,61.7,3054065,2950686,103379,3.4
2018,Mar,63.8,61.7,3054534,2952953,101581,3.3
2018,Apr,63.8,61.7,3054401,2955083,99318,3.3
2018,May,63.8,61.7,3053081,2956121,96960,3.2
2018,Jun,63.7,61.7,3050976,2956351,94625,3.1
2018,Jul,63.6,61.7,3048597,2956269,92328,3
2018,Aug,63.6,61.7,3047578,2956632,90946,3
2018,Sep,63.6,61.7,3049023,2957990,91033,3
2018,Oct,63.6,61.7,3052936,2960320,92616,3
2018,Nov,63.7,61.7,3058275,2963187,95088,3.1
2018,Dec,63.8,61.8,3063304,2965735,97569,3.2
2019,Jan,63.9,61.8,3066433,2967251,99182,3.2
2019,Feb,63.9,61.8,3066996,2967458,99538,3.2
2019,Mar,63.8,61.8,3066036,2967068,98968,3.2
2019,Apr,63.8,61.7,3065263,2967502,97761,3.2
2019,May,63.8,61.8,3066057,2969628,96429,3.1
2019,Jun,63.8,61.8,3069636,2973695,95941,3.1
2019,Jul,64,61.9,3077388,2980183,97205,3.2
2019,Aug,64.1,62.1,3087074,2987335,99739,3.2
2019,Sep,64.3,62.2,3096836,2994012,102824,3.3
2019,Oct,64.4,62.2,3104105,2998448,105657,3.4
2019,Nov,64.4,62.2,3105035,2998582,106453,3.4
2019,Dec,64.4,62.2,3104134,2997762,106372,3.4
2020,Jan,64.5,62.2,3111534,3001253,110281,3.5
2020,Feb,64.5,62.2,3111767,3002151,109616,3.5
2020,Mar,65.2,62.7,3145755,3024168,121587,3.9
2020,Apr,62.8,56.4,3029038,2720544,308494,10.2
2020,May,62.4,56.1,3013333,2709686,303647,10.1
2020,Jun,62.7,57.8,3027726,2791523,236203,7.8
2020,Jul,63.6,59.2,3073320,2861896,211424,6.9
2020,Aug,63.7,59.3,3080741,2866345,214396,7
2020,Sep,62.3,59.2,3011046,2864995,146051,4.9
