Year,Period,labor force participation rate,employment-population ratio,labor force,employment,unemployment,unemployment rate
1976,Jan,61.6,58,327276,308066,19210,5.9
1976,Feb,61.5,57.9,327202,308039,19163,5.9
1976,Mar,61.4,57.8,327131,308017,19114,5.8
1976,Apr,61.3,57.7,327166,308014,19152,5.9
1976,May,61.2,57.6,327296,308035,19261,5.9
1976,Jun,61.2,57.5,327764,308353,19411,5.9
1976,Jul,61.2,57.6,328695,309084,19611,6
1976,Aug,61.4,57.7,330148,310336,19812,6
1976,Sep,61.6,57.9,332042,312065,19977,6
1976,Oct,61.9,58.2,334208,314062,20146,6
1976,Nov,62.1,58.3,336362,316059,20303,6
1976,Dec,62.3,58.5,338284,317850,20434,6
1977,Jan,62.5,58.7,340045,319466,20579,6.1
1977,Feb,62.7,58.9,341605,320845,20760,6.1
1977,Mar,62.8,59,342989,322026,20963,6.1
1977,Apr,63,59.1,344561,323360,21201,6.2
1977,May,63.1,59.2,346442,324941,21501,6.2
1977,Jun,63.3,59.4,348399,326582,21817,6.3
1977,Jul,63.6,59.5,350246,328108,22138,6.3
1977,Aug,63.8,59.7,351912,329454,22458,6.4
1977,Sep,63.8,59.7,353367,330630,22737,6.4
1977,Oct,63.9,59.8,354692,331708,22984,6.5
1977,Nov,64,59.9,356040,332836,23204,6.5
1977,Dec,64.2,60,357504,334176,23328,6.5
1978,Jan,64.2,60.1,359023,335744,23279,6.5
1978,Feb,64.4,60.3,360665,337629,23036,6.4
1978,Mar,64.6,60.6,362440,339795,22645,6.2
1978,Apr,64.8,60.8,364136,341975,22161,6.1
1978,May,64.8,61,365708,344093,21615,5.9
1978,Jun,65,61.3,367157,346099,21058,5.7
1978,Jul,65.1,61.5,368365,347851,20514,5.6
1978,Aug,65.1,61.6,369189,349138,20051,5.4
1978,Sep,65.2,61.7,369522,349802,19720,5.3
1978,Oct,65,61.6,369284,349843,19441,5.3
1978,Nov,64.9,61.5,368580,349393,19187,5.2
1978,Dec,64.6,61.3,367716,348728,18988,5.2
1979,Jan,64.5,61.2,367132,348300,18832,5.1
1979,Feb,64.4,61.1,367125,348400,18725,5.1
1979,Mar,64.4,61.1,367710,349034,18676,5.1
1979,Apr,64.6,61.3,368813,350122,18691,5.1
1979,May,64.7,61.4,370216,351420,18796,5.1
1979,Jun,65,61.7,371659,352668,18991,5.1
1979,Jul,65.1,61.7,372858,353646,19212,5.2
1979,Aug,65.2,61.8,373660,354267,19393,5.2
1979,Sep,65.3,61.9,374154,354630,19524,5.2
1979,Oct,65.4,61.9,374539,354893,19646,5.2
1979,Nov,65.4,62,374958,355129,19829,5.3
1979,Dec,65.5,62,375405,355269,20136,5.4
1980,Jan,65.6,62,375699,355143,20556,5.5
1980,Feb,65.6,61.9,375682,354621,21061,5.6
1980,Mar,65.5,61.7,375380,353751,21629,5.8
1980,Apr,65.4,61.5,374785,352582,22203,5.9
1980,May,65.2,61.2,374056,351317,22739,6.1
1980,Jun,65.1,61,373517,350322,23195,6.2
1980,Jul,64.9,60.8,373454,349883,23571,6.3
1980,Aug,65.1,60.9,374052,350201,23851,6.4
1980,Sep,65.2,61,375323,351274,24049,6.4
1980,Oct,65.4,61.2,377080,352895,24185,6.4
1980,Nov,65.7,61.5,379028,354802,24226,6.4
1980,Dec,65.9,61.7,380892,356693,24199,6.4
1981,Jan,66.2,62,382470,358243,24227,6.3
1981,Feb,66.3,62.1,383606,359274,24332,6.3
1981,Mar,66.3,62,384265,359780,24485,6.4
1981,Apr,66.3,62,384567,359845,24722,6.4
1981,May,66.2,61.9,384652,359585,25067,6.5
1981,Jun,66.2,61.8,384679,359137,25542,6.6
1981,Jul,66.1,61.6,384865,358710,26155,6.8
1981,Aug,66.1,61.5,385237,358395,26842,7
1981,Sep,66.2,61.4,385690,358140,27550,7.1
1981,Oct,66.1,61.3,386155,357858,28297,7.3
1981,Nov,66.2,61.2,386553,357425,29128,7.5
1981,Dec,66.1,61,386825,356831,29994,7.8
1982,Jan,66.2,60.9,387002,356153,30849,8
1982,Feb,66.1,60.7,387157,355497,31660,8.2
1982,Mar,66.1,60.6,387357,354991,32366,8.4
1982,Apr,66,60.4,387601,354725,32876,8.5
1982,May,66.1,60.4,387871,354715,33156,8.5
1982,Jun,66,60.4,388161,354899,33262,8.6
1982,Jul,66.1,60.4,388514,355208,33306,8.6
1982,Aug,66,60.4,389014,355609,33405,8.6
1982,Sep,66.1,60.4,389701,356084,33617,8.6
1982,Oct,66.2,60.4,390526,356611,33915,8.7
1982,Nov,66.2,60.4,391410,357183,34227,8.7
1982,Dec,66.3,60.4,392232,357742,34490,8.8
1983,Jan,66.3,60.4,392881,358248,34633,8.8
1983,Feb,66.3,60.5,393418,358755,34663,8.8
1983,Mar,66.3,60.5,393922,359266,34656,8.8
1983,Apr,66.3,60.5,394571,359910,34661,8.8
1983,May,66.4,60.5,395475,360796,34679,8.8
1983,Jun,66.5,60.7,396556,361887,34669,8.7
1983,Jul,66.6,60.8,397664,363068,34596,8.7
1983,Aug,66.8,61,398605,364158,34447,8.6
1983,Sep,66.8,61,399219,365052,34167,8.6
1983,Oct,66.8,61.2,399468,365765,33703,8.4
1983,Nov,66.7,61.2,399469,366356,33113,8.3
1983,Dec,66.7,61.3,399415,366941,32474,8.1
1984,Jan,66.7,61.4,399519,367658,31861,8
1984,Feb,66.6,61.4,399890,368520,31370,7.8
1984,Mar,66.8,61.6,400539,369472,31067,7.8
1984,Apr,66.8,61.6,401361,370404,30957,7.7
1984,May,66.9,61.8,402140,371185,30955,7.7
1984,Jun,66.9,61.8,402728,371796,30932,7.7
1984,Jul,66.9,61.8,402995,372259,30736,7.6
1984,Aug,66.9,61.9,402970,372610,30360,7.5
1984,Sep,66.9,61.9,402771,372833,29938,7.4
1984,Oct,66.9,61.9,402484,372871,29613,7.4
1984,Nov,66.7,61.8,402231,372743,29488,7.3
1984,Dec,66.7,61.8,402162,372541,29621,7.4
1985,Jan,66.7,61.7,402308,372346,29962,7.4
1985,Feb,66.8,61.7,402547,372211,30336,7.5
1985,Mar,66.8,61.7,402800,372219,30581,7.6
1985,Apr,66.8,61.7,402999,372352,30647,7.6
1985,May,66.7,61.7,403112,372502,30610,7.6
1985,Jun,66.7,61.7,403114,372564,30550,7.6
1985,Jul,66.7,61.7,403022,372432,30590,7.6
1985,Aug,66.7,61.6,402882,372125,30757,7.6
1985,Sep,66.8,61.7,402788,371784,31004,7.7
1985,Oct,66.8,61.6,402883,371566,31317,7.8
1985,Nov,66.9,61.6,403146,371533,31613,7.8
1985,Dec,67,61.7,403432,371592,31840,7.9
1986,Jan,67,61.7,403638,371635,32003,7.9
1986,Feb,67.1,61.7,403697,371582,32115,8
1986,Mar,67.1,61.8,403483,371321,32162,8
1986,Apr,67,61.7,402947,370816,32131,8
1986,May,66.9,61.6,402226,370203,32023,8
1986,Jun,66.9,61.6,401498,369607,31891,7.9
1986,Jul,66.8,61.5,400922,369129,31793,7.9
1986,Aug,66.8,61.5,400575,368827,31748,7.9
1986,Sep,66.7,61.5,400463,368712,31751,7.9
1986,Oct,66.9,61.6,400509,368776,31733,7.9
1986,Nov,66.9,61.6,400617,368990,31627,7.9
1986,Dec,66.9,61.7,400742,369385,31357,7.8
1987,Jan,66.9,61.7,400748,369831,30917,7.7
1987,Feb,67,61.9,400568,370177,30391,7.6
1987,Mar,66.9,61.9,400319,370414,29905,7.5
1987,Apr,66.9,62,400116,370554,29562,7.4
1987,May,66.9,62,400051,370640,29411,7.4
1987,Jun,67,62.1,400185,370726,29459,7.4
1987,Jul,67.1,62.1,400532,370905,29627,7.4
1987,Aug,67.2,62.2,401051,371233,29818,7.4
1987,Sep,67.3,62.3,401646,371717,29929,7.5
1987,Oct,67.4,62.4,402238,372343,29895,7.4
1987,Nov,67.5,62.5,402766,373058,29708,7.4
1987,Dec,67.5,62.6,403164,373740,29424,7.3
1988,Jan,67.6,62.7,403497,374396,29101,7.2
1988,Feb,67.8,62.9,403818,375026,28792,7.1
1988,Mar,67.8,63,404039,375514,28525,7.1
1988,Apr,67.8,63.1,404172,375897,28275,7
1988,May,67.8,63.1,404246,376261,27985,6.9
1988,Jun,67.8,63.2,404352,376774,27578,6.8
1988,Jul,67.9,63.3,404554,377539,27015,6.7
1988,Aug,67.9,63.5,404819,378480,26339,6.5
1988,Sep,68,63.7,405117,379468,25649,6.3
1988,Oct,68,63.8,405357,380320,25037,6.2
1988,Nov,68,63.9,405509,380944,24565,6.1
1988,Dec,68.1,64,405595,381336,24259,6
1989,Jan,68.1,64,405684,381592,24092,5.9
1989,Feb,68.1,64.1,405938,381928,24010,5.9
1989,Mar,68.2,64.2,406512,382547,23965,5.9
1989,Apr,68.4,64.3,407380,383449,23931,5.9
1989,May,68.5,64.5,408390,384493,23897,5.9
1989,Jun,68.7,64.7,409298,385436,23862,5.8
1989,Jul,68.8,64.8,409954,386134,23820,5.8
1989,Aug,68.8,64.9,410333,386625,23708,5.8
1989,Sep,68.7,64.8,410421,386931,23490,5.7
1989,Oct,68.7,64.9,410360,387174,23186,5.7
1989,Nov,68.7,64.9,410326,387480,22846,5.6
1989,Dec,68.8,65,410493,387942,22551,5.5
1990,Jan,69,65.3,410956,388570,22386,5.4
1990,Feb,69.2,65.4,411632,389242,22390,5.4
1990,Mar,69.3,65.5,412411,389869,22542,5.5
1990,Apr,69.4,65.6,413148,390346,22802,5.5
1990,May,67.4,63.5,400801,377668,23133,5.8
1990,Jun,66.8,62.9,397458,373940,23518,5.9
1990,Jul,66.7,62.7,396838,372887,23951,6
1990,Aug,66.7,62.6,397137,372688,24449,6.2
1990,Sep,66.8,62.6,397895,372899,24996,6.3
1990,Oct,66.9,62.6,398923,373343,25580,6.4
1990,Nov,66.9,62.6,400059,373835,26224,6.6
1990,Dec,67.1,62.6,401103,374225,26878,6.7
1991,Jan,67.1,62.6,401861,374414,27447,6.8
1991,Feb,67.1,62.5,402296,374437,27859,6.9
1991,Mar,67.1,62.5,402521,374445,28076,7
1991,Apr,67.1,62.4,402778,374684,28094,7
1991,May,67.2,62.5,403290,375338,27952,6.9
1991,Jun,67.2,62.6,404105,376360,27745,6.9
1991,Jul,67.3,62.7,405221,377603,27618,6.8
1991,Aug,67.4,62.8,406611,378927,27684,6.8
1991,Sep,67.5,62.9,408168,380218,27950,6.8
1991,Oct,67.7,63,409752,381444,28308,6.9
1991,Nov,67.8,63.1,411233,382657,28576,6.9
1991,Dec,68.1,63.3,412577,383908,28669,6.9
1992,Jan,68.2,63.4,413857,385237,28620,6.9
1992,Feb,68.3,63.6,415117,386626,28491,6.9
1992,Mar,68.3,63.7,416270,387916,28354,6.8
1992,Apr,68.4,63.7,417179,388900,28279,6.8
1992,May,68.4,63.7,417748,389450,28298,6.8
1992,Jun,68.3,63.7,418053,389683,28370,6.8
1992,Jul,68.2,63.6,418195,389817,28378,6.8
1992,Aug,68.1,63.5,418239,389964,28275,6.8
1992,Sep,68,63.5,418258,390193,28065,6.7
1992,Oct,67.8,63.3,418345,390567,27778,6.6
1992,Nov,67.8,63.3,418586,391124,27462,6.6
1992,Dec,67.7,63.3,419005,391858,27147,6.5
1993,Jan,67.7,63.4,419575,392733,26842,6.4
1993,Feb,67.7,63.4,420270,393682,26588,6.3
1993,Mar,67.6,63.4,421091,394678,26413,6.3
1993,Apr,67.7,63.4,421941,395656,26285,6.2
1993,May,67.7,63.5,422693,396534,26159,6.2
1993,Jun,67.7,63.5,423223,397220,26003,6.1
1993,Jul,67.6,63.5,423464,397685,25779,6.1
1993,Aug,67.4,63.3,423541,398099,25442,6
1993,Sep,67.3,63.3,423611,398631,24980,5.9
1993,Oct,67.2,63.3,423790,399327,24463,5.8
1993,Nov,67.1,63.3,424160,400202,23958,5.6
1993,Dec,67.1,63.4,424780,401266,23514,5.5
1994,Jan,67.1,63.4,425592,402470,23122,5.4
1994,Feb,67.1,63.5,426494,403725,22769,5.3
1994,Mar,67.2,63.7,427472,405016,22456,5.3
1994,Apr,67.3,63.8,428631,406413,22218,5.2
1994,May,67.3,63.8,430022,407936,22086,5.1
1994,Jun,67.4,64,431564,409503,22061,5.1
1994,Jul,67.6,64.1,433164,410996,22168,5.1
1994,Aug,67.7,64.2,434602,412266,22336,5.1
1994,Sep,67.7,64.2,435868,413262,22606,5.2
1994,Oct,67.8,64.2,437067,414068,22999,5.3
1994,Nov,67.7,64.1,438154,414723,23431,5.3
1994,Dec,67.8,64.1,439015,415177,23838,5.4
1995,Jan,67.8,64,439659,415464,24195,5.5
1995,Feb,67.6,63.9,440184,415716,24468,5.6
1995,Mar,67.6,63.8,440652,415998,24654,5.6
1995,Apr,67.6,63.8,441134,416357,24777,5.6
1995,May,67.6,63.8,441752,416883,24869,5.6
1995,Jun,67.5,63.7,442582,417591,24991,5.6
1995,Jul,67.5,63.7,443562,418378,25184,5.7
1995,Aug,67.6,63.7,444555,419118,25437,5.7
1995,Sep,67.6,63.7,445316,419698,25618,5.8
1995,Oct,67.6,63.7,445699,420087,25612,5.7
1995,Nov,67.5,63.6,445906,420411,25495,5.7
1995,Dec,67.4,63.6,446185,420885,25300,5.7
1996,Jan,67.4,63.6,446667,421599,25068,5.6
1996,Feb,67.4,63.7,447346,422492,24854,5.6
1996,Mar,67.4,63.7,448133,423452,24681,5.5
1996,Apr,67.5,63.8,448879,424339,24540,5.5
1996,May,67.4,63.8,449455,425055,24400,5.4
1996,Jun,67.4,63.8,449844,425659,24185,5.4
1996,Jul,67.3,63.8,450068,426221,23847,5.3
1996,Aug,67.4,63.9,450193,426734,23459,5.2
1996,Sep,67.3,63.8,450262,427150,23112,5.1
1996,Oct,67.2,63.8,450269,427411,22858,5.1
1996,Nov,67.2,63.8,450208,427445,22763,5.1
1996,Dec,67.1,63.7,450136,427274,22862,5.1
1997,Jan,67.1,63.6,450130,427020,23110,5.1
1997,Feb,67,63.5,450239,426805,23434,5.2
1997,Mar,67,63.5,450499,426740,23759,5.3
1997,Apr,67.1,63.5,450895,426879,24016,5.3
1997,May,67.1,63.5,451386,427212,24174,5.4
1997,Jun,67.2,63.6,451918,427673,24245,5.4
1997,Jul,67.1,63.5,452504,428248,24256,5.4
1997,Aug,67.3,63.7,453216,428954,24262,5.4
1997,Sep,67.3,63.7,454100,429783,24317,5.4
1997,Oct,67.4,63.8,455119,430645,24474,5.4
1997,Nov,67.6,63.9,456113,431427,24686,5.4
1997,Dec,67.7,64,456939,432034,24905,5.5
1998,Jan,67.7,64,457533,432407,25126,5.5
1998,Feb,67.8,64,457927,432620,25307,5.5
1998,Mar,67.8,64.1,458196,432794,25402,5.5
1998,Apr,67.9,64.1,458456,433051,25405,5.5
1998,May,67.9,64.2,458835,433481,25354,5.5
1998,Jun,68,64.3,459424,434102,25322,5.5
1998,Jul,68,64.3,460267,434896,25371,5.5
1998,Aug,68.2,64.4,461255,435771,25484,5.5
1998,Sep,68.2,64.4,462222,436586,25636,5.5
1998,Oct,68.3,64.5,463015,437232,25783,5.6
1998,Nov,68.3,64.5,463563,437726,25837,5.6
1998,Dec,68.4,64.6,463849,438082,25767,5.6
1999,Jan,68.4,64.6,463880,438325,25555,5.5
1999,Feb,68.3,64.6,463778,438537,25241,5.4
1999,Mar,68.3,64.6,463706,438793,24913,5.4
1999,Apr,68.3,64.7,463762,439123,24639,5.3
1999,May,68.2,64.6,463953,439501,24452,5.3
1999,Jun,68.2,64.7,464190,439863,24327,5.2
1999,Jul,68.2,64.6,464400,440181,24219,5.2
1999,Aug,68.2,64.7,464596,440485,24111,5.2
1999,Sep,68.2,64.6,464846,440841,24005,5.2
1999,Oct,68.1,64.6,465224,441325,23899,5.1
1999,Nov,68.2,64.7,465742,441943,23799,5.1
1999,Dec,68.2,64.7,466380,442677,23703,5.1
2000,Jan,68.3,64.8,467085,443477,23608,5.1
2000,Feb,68.3,64.9,467691,444171,23520,5
2000,Mar,68.3,64.9,468063,444620,23443,5
2000,Apr,68.3,64.9,468226,444833,23393,5
2000,May,68.2,64.8,468200,444841,23359,5
2000,Jun,68.2,64.8,468032,444698,23334,5
2000,Jul,68.1,64.7,467724,444420,23304,5
2000,Aug,68,64.6,467304,444092,23212,5
2000,Sep,67.8,64.5,466889,443871,23018,4.9
2000,Oct,67.7,64.4,466574,443851,22723,4.9
2000,Nov,67.7,64.4,466423,444039,22384,4.8
2000,Dec,67.6,64.4,466461,444397,22064,4.7
2001,Jan,67.6,64.4,466668,444858,21810,4.7
2001,Feb,67.6,64.5,466962,445328,21634,4.6
2001,Mar,67.6,64.5,467168,445659,21509,4.6
2001,Apr,67.5,64.4,467098,445699,21399,4.6
2001,May,67.4,64.4,466725,445440,21285,4.6
2001,Jun,67.3,64.2,466176,445025,21151,4.5
2001,Jul,67.2,64.1,465615,444604,21011,4.5
2001,Aug,67,64,465176,444287,20889,4.5
2001,Sep,66.9,63.9,464902,444124,20778,4.5
2001,Oct,66.9,63.9,464847,444149,20698,4.5
2001,Nov,66.8,63.9,465001,444318,20683,4.4
2001,Dec,66.8,63.8,465253,444533,20720,4.5
2002,Jan,66.8,63.8,465502,444715,20787,4.5
2002,Feb,66.8,63.8,465738,444877,20861,4.5
2002,Mar,66.8,63.8,465951,445059,20892,4.5
2002,Apr,66.8,63.8,466131,445312,20819,4.5
2002,May,66.7,63.8,466308,445677,20631,4.4
2002,Jun,66.7,63.8,466509,446126,20383,4.4
2002,Jul,66.7,63.8,466820,446655,20165,4.3
2002,Aug,66.7,63.8,467293,447223,20070,4.3
2002,Sep,66.7,63.8,467897,447757,20140,4.3
2002,Oct,66.7,63.8,468525,448189,20336,4.3
2002,Nov,66.7,63.8,469091,448496,20595,4.4
2002,Dec,66.7,63.7,469565,448693,20872,4.4
2003,Jan,66.7,63.7,469870,448740,21130,4.5
2003,Feb,66.6,63.6,469926,448585,21341,4.5
2003,Mar,66.6,63.5,469842,448314,21528,4.6
2003,Apr,66.5,63.5,469810,448073,21737,4.6
2003,May,66.5,63.4,469968,448007,21961,4.7
2003,Jun,66.5,63.3,470395,448215,22180,4.7
2003,Jul,66.5,63.3,471045,448671,22374,4.7
2003,Aug,66.5,63.3,471825,449274,22551,4.8
2003,Sep,66.5,63.3,472648,449909,22739,4.8
2003,Oct,66.6,63.3,473412,450470,22942,4.8
2003,Nov,66.6,63.3,474108,450986,23122,4.9
2003,Dec,66.6,63.3,474797,451549,23248,4.9
2004,Jan,66.7,63.4,475622,452309,23313,4.9
2004,Feb,66.7,63.5,476694,453384,23310,4.9
2004,Mar,66.8,63.6,477930,454682,23248,4.9
2004,Apr,66.9,63.7,479150,455996,23154,4.8
2004,May,67,63.8,480202,457123,23079,4.8
2004,Jun,67,63.8,480975,457943,23032,4.8
2004,Jul,67,63.8,481471,458514,22957,4.8
2004,Aug,67,63.8,481756,458925,22831,4.7
2004,Sep,66.9,63.8,481958,459291,22667,4.7
2004,Oct,66.9,63.8,482219,459726,22493,4.7
2004,Nov,66.8,63.8,482560,460226,22334,4.6
2004,Dec,66.8,63.8,482910,460707,22203,4.6
2005,Jan,66.8,63.7,483216,461130,22086,4.6
2005,Feb,66.8,63.7,483447,461465,21982,4.5
2005,Mar,66.7,63.7,483640,461764,21876,4.5
2005,Apr,66.7,63.7,483902,462157,21745,4.5
2005,May,66.7,63.7,484338,462760,21578,4.5
2005,Jun,66.7,63.7,485027,463655,21372,4.4
2005,Jul,66.7,63.8,485943,464773,21170,4.4
2005,Aug,66.8,63.9,486967,466016,20951,4.3
2005,Sep,66.8,64,487942,467299,20643,4.2
2005,Oct,66.8,64,488727,468484,20243,4.1
2005,Nov,66.8,64.1,489304,469521,19783,4
2005,Dec,66.7,64.1,489764,470448,19316,3.9
2006,Jan,66.7,64.2,490268,471379,18889,3.9
2006,Feb,66.8,64.2,491041,472510,18531,3.8
2006,Mar,66.8,64.4,492154,473899,18255,3.7
2006,Apr,66.9,64.5,493417,475372,18045,3.7
2006,May,67,64.6,494503,476642,17861,3.6
2006,Jun,67,64.6,495124,477461,17663,3.6
2006,Jul,66.9,64.6,495183,477775,17408,3.5
2006,Aug,66.8,64.5,494839,477774,17065,3.4
2006,Sep,66.6,64.4,494357,477703,16654,3.4
2006,Oct,66.5,64.3,494053,477899,16154,3.3
2006,Nov,66.4,64.3,494193,478609,15584,3.2
2006,Dec,66.4,64.4,494856,479823,15033,3
2007,Jan,66.5,64.5,495923,481280,14643,3
2007,Feb,66.6,64.6,497134,482575,14559,2.9
2007,Mar,66.7,64.7,498331,483471,14860,3
2007,Apr,66.8,64.7,499492,483948,15544,3.1
2007,May,66.8,64.6,500637,484114,16523,3.3
2007,Jun,66.9,64.6,501787,484149,17638,3.5
2007,Jul,67,64.5,502912,484200,18712,3.7
2007,Aug,67,64.4,503942,484343,19599,3.9
2007,Sep,67.1,64.4,504881,484635,20246,4
2007,Oct,67.1,64.4,505775,485083,20692,4.1
2007,Nov,67.2,64.4,506613,485584,21029,4.2
2007,Dec,67.2,64.4,507391,486056,21335,4.2
2008,Jan,67.2,64.3,508059,486363,21696,4.3
2008,Feb,67.2,64.3,508539,486383,22156,4.4
2008,Mar,67.2,64.2,508814,486087,22727,4.5
2008,Apr,67.1,64,508950,485549,23401,4.6
2008,May,67.1,63.9,509059,484899,24160,4.7
2008,Jun,67,63.7,509232,484231,25001,4.9
2008,Jul,67,63.6,509525,483625,25900,5.1
2008,Aug,67,63.4,509867,482985,26882,5.3
2008,Sep,66.9,63.3,510063,482096,27967,5.5
2008,Oct,66.9,63,509861,480689,29172,5.7
2008,Nov,66.7,62.7,509133,478664,30469,6
2008,Dec,66.5,62.3,507892,476130,31762,6.3
2009,Jan,66.3,61.9,506319,473400,32919,6.5
2009,Feb,66,61.6,504705,470898,33807,6.7
2009,Mar,65.8,61.3,503244,468904,34340,6.8
2009,Apr,65.6,61.1,502025,467514,34511,6.9
2009,May,65.4,60.9,501035,466642,34393,6.9
2009,Jun,65.2,60.8,500238,466120,34118,6.8
2009,Jul,65.1,60.7,499615,465730,33885,6.8
2009,Aug,65,60.6,499182,465335,33847,6.8
2009,Sep,64.9,60.5,498953,464901,34052,6.8
2009,Oct,64.9,60.4,498953,464459,34494,6.9
2009,Nov,64.9,60.3,499194,464090,35104,7
2009,Dec,64.9,60.2,499622,463837,35785,7.2
2010,Jan,64.9,60.2,500111,463719,36392,7.3
2010,Feb,64.9,60.2,500537,463715,36822,7.4
2010,Mar,64.9,60.1,500852,463843,37009,7.4
2010,Apr,64.4,59.7,501056,464095,36961,7.4
2010,May,64.4,59.7,501155,464415,36740,7.3
2010,Jun,64.4,59.7,501110,464658,36452,7.3
2010,Jul,64.3,59.7,500905,464705,36200,7.2
2010,Aug,64.2,59.6,500619,464543,36076,7.2
2010,Sep,64.2,59.5,500334,464216,36118,7.2
2010,Oct,64.1,59.4,500103,463831,36272,7.3
2010,Nov,64,59.4,499959,463507,36452,7.3
2010,Dec,64,59.3,499925,463359,36566,7.3
2011,Jan,64,59.3,500012,463453,36559,7.3
2011,Feb,63.9,59.3,500123,463721,36402,7.3
2011,Mar,63.9,59.3,500168,464042,36126,7.2
2011,Apr,63.9,59.3,500186,464387,35799,7.2
2011,May,63.9,59.3,500285,464791,35494,7.1
2011,Jun,63.9,59.4,500562,465336,35226,7
2011,Jul,63.9,59.4,501016,466076,34940,7
2011,Aug,63.9,59.5,501574,467018,34556,6.9
2011,Sep,63.9,59.6,502148,468110,34038,6.8
2011,Oct,63.9,59.7,502636,469230,33406,6.6
2011,Nov,63.9,59.8,502954,470237,32717,6.5
2011,Dec,63.9,59.8,503131,471075,32056,6.4
2012,Jan,63.9,59.9,503294,471779,31515,6.3
2012,Feb,63.9,59.9,503616,472467,31149,6.2
2012,Mar,63.9,60,504198,473238,30960,6.1
2012,Apr,64,60.1,504977,474093,30884,6.1
2012,May,64.1,60.2,505872,475038,30834,6.1
2012,Jun,64.1,60.2,506766,476037,30729,6.1
2012,Jul,64.2,60.3,507498,476991,30507,6
2012,Aug,64.2,60.4,507991,477822,30169,5.9
2012,Sep,64.1,60.4,508298,478528,29770,5.9
2012,Oct,64.1,60.4,508529,479170,29359,5.8
2012,Nov,64.1,60.4,508777,479779,28998,5.7
2012,Dec,64.1,60.5,509093,480377,28716,5.6
2013,Jan,64.1,60.5,509413,480899,28514,5.6
2013,Feb,64.1,60.5,509850,481468,28382,5.6
2013,Mar,64.1,60.5,510186,481898,28288,5.5
2013,Apr,64,60.5,510345,482166,28179,5.5
2013,May,64,60.5,510327,482291,28036,5.5
2013,Jun,63.9,60.4,510270,482407,27863,5.5
2013,Jul,63.9,60.4,510389,482699,27690,5.4
2013,Aug,63.8,60.4,510712,483211,27501,5.4
2013,Sep,63.8,60.4,511146,483891,27255,5.3
2013,Oct,63.8,60.5,511592,484636,26956,5.3
2013,Nov,63.8,60.5,511924,485311,26613,5.2
2013,Dec,63.8,60.5,512004,485779,26225,5.1
2014,Jan,63.8,60.6,512419,486623,25796,5
2014,Feb,63.7,60.6,512047,486714,25333,4.9
2014,Mar,63.7,60.6,511775,486896,24879,4.9
2014,Apr,63.6,60.6,511753,487271,24482,4.8
2014,May,63.6,60.6,511978,487843,24135,4.7
2014,Jun,63.6,60.6,512321,488472,23849,4.7
2014,Jul,63.6,60.6,512578,488948,23630,4.6
2014,Aug,63.5,60.6,512666,489222,23444,4.6
2014,Sep,63.5,60.6,512662,489404,23258,4.5
2014,Oct,63.4,60.5,512676,489663,23013,4.5
2014,Nov,63.4,60.6,512874,490199,22675,4.4
2014,Dec,63.4,60.6,513368,491087,22281,4.3
2015,Jan,63.4,60.7,514152,492201,21951,4.3
2015,Feb,63.5,60.8,515011,493352,21659,4.2
2015,Mar,63.6,60.9,515785,494300,21485,4.2
2015,Apr,63.6,60.9,516343,494913,21430,4.2
2015,May,63.6,60.9,516695,495227,21468,4.2
2015,Jun,63.6,60.9,516971,495441,21530,4.2
2015,Jul,63.6,60.9,517370,495812,21558,4.2
2015,Aug,63.6,60.9,518002,496427,21575,4.2
2015,Sep,63.6,61,518785,497183,21602,4.2
2015,Oct,63.6,61,519628,497967,21661,4.2
2015,Nov,63.7,61,520439,498677,21762,4.2
2015,Dec,63.7,61,521130,499243,21887,4.2
2016,Jan,63.7,61,521657,499647,22010,4.2
2016,Feb,63.7,61,522007,499902,22105,4.2
2016,Mar,63.7,61,522190,500041,22149,4.2
2016,Apr,63.6,60.9,522300,500176,22124,4.2
2016,May,63.6,60.9,522398,500358,22040,4.2
2016,Jun,63.5,60.9,522465,500585,21880,4.2
2016,Jul,63.5,60.8,522518,500854,21664,4.1
2016,Aug,63.4,60.8,522601,501159,21442,4.1
2016,Sep,63.4,60.8,522740,501496,21244,4.1
2016,Oct,63.3,60.7,522905,501814,21091,4
2016,Nov,63.3,60.7,523088,502106,20982,4
2016,Dec,63.2,60.7,523331,502422,20909,4
2017,Jan,63.2,60.7,523682,502819,20863,4
2017,Feb,63.2,60.7,524142,503310,20832,4
2017,Mar,63.2,60.7,524653,503847,20806,4
2017,Apr,63.2,60.7,525152,504360,20792,4
2017,May,63.2,60.7,525591,504808,20783,4
2017,Jun,63.2,60.7,525939,505142,20797,4
2017,Jul,63.1,60.6,526155,505332,20823,4
2017,Aug,63.1,60.6,526236,505442,20794,4
2017,Sep,63,60.5,526271,505558,20713,3.9
2017,Oct,62.9,60.5,526359,505766,20593,3.9
2017,Nov,62.9,60.5,526503,506057,20446,3.9
2017,Dec,62.9,60.5,526665,506396,20269,3.8
2018,Jan,62.9,60.5,526863,506795,20068,3.8
2018,Feb,62.8,60.5,527149,507281,19868,3.8
2018,Mar,62.8,60.5,527522,507839,19683,3.7
2018,Apr,62.8,60.5,527913,508392,19521,3.7
2018,May,62.8,60.5,528265,508873,19392,3.7
2018,Jun,62.8,60.5,528573,509288,19285,3.6
2018,Jul,62.8,60.5,528881,509696,19185,3.6
2018,Aug,62.8,60.5,529238,510153,19085,3.6
2018,Sep,62.8,60.5,529646,510687,18959,3.6
2018,Oct,62.7,60.5,530058,511240,18818,3.6
2018,Nov,62.7,60.5,530431,511732,18699,3.5
2018,Dec,62.7,60.5,530733,512115,18618,3.5
2019,Jan,62.7,60.5,530894,512326,18568,3.5
2019,Feb,62.7,60.5,530934,512411,18523,3.5
2019,Mar,62.6,60.5,531051,512569,18482,3.5
2019,Apr,62.6,60.5,531418,512970,18448,3.5
2019,May,62.7,60.5,532100,513669,18431,3.5
2019,Jun,62.7,60.6,533068,514618,18450,3.5
2019,Jul,62.8,60.6,534199,515685,18514,3.5
2019,Aug,62.9,60.7,535105,516494,18611,3.5
2019,Sep,62.9,60.7,535725,517014,18711,3.5
2019,Oct,62.8,60.6,535978,517221,18757,3.5
2019,Nov,62.8,60.6,535823,517084,18739,3.5
2019,Dec,62.7,60.5,535694,516978,18716,3.5
2020,Jan,62.8,60.6,536520,517842,18678,3.5
2020,Feb,62.8,60.6,537336,518642,18694,3.5
2020,Mar,62.9,60.7,538777,519559,19218,3.6
2020,Apr,60.8,53.5,520588,458407,62181,11.9
2020,May,61.1,55.6,523851,476592,47259,9
2020,Jun,62.4,57.9,535115,496827,38288,7.2
2020,Jul,62.2,58.2,534260,499687,34573,6.5
2020,Aug,62,58.4,533234,502250,30984,5.8
2020,Sep,62.1,58.9,534614,506500,28114,5.3
