Year,Period,labor force participation rate,employment-population ratio,labor force,employment,unemployment,unemployment rate
1976,Jan,62.6,56.5,1074151,969974,104177,9.7
1976,Feb,62.4,56.4,1073446,969351,104095,9.7
1976,Mar,62.2,56.2,1072689,969546,103143,9.6
1976,Apr,62.1,56.3,1073735,972719,101016,9.4
1976,May,62.1,56.4,1076382,977331,99051,9.2
1976,Jun,62.3,56.6,1081143,983132,98011,9.1
1976,Jul,62.5,56.9,1087537,989212,98325,9
1976,Aug,62.7,57,1094762,995155,99607,9.1
1976,Sep,63,57.2,1102269,1001249,101020,9.2
1976,Oct,63.2,57.4,1109712,1007315,102397,9.2
1976,Nov,63.4,57.5,1116657,1013272,103385,9.3
1976,Dec,63.6,57.7,1122897,1019266,103631,9.2
1977,Jan,63.7,57.9,1128671,1025657,103014,9.1
1977,Feb,63.8,58.1,1134110,1032891,101219,8.9
1977,Mar,63.9,58.4,1139258,1041049,98209,8.6
1977,Apr,64,58.8,1144263,1049879,94384,8.2
1977,May,64.1,59.1,1149169,1058915,90254,7.9
1977,Jun,64.2,59.4,1153957,1067749,86208,7.5
1977,Jul,64.3,59.7,1158832,1076153,82679,7.1
1977,Aug,64.4,60,1163933,1084133,79800,6.9
1977,Sep,64.5,60.2,1169060,1091817,77243,6.6
1977,Oct,64.6,60.5,1173870,1099242,74628,6.4
1977,Nov,64.6,60.7,1178391,1106421,71970,6.1
1977,Dec,64.7,60.9,1182769,1113201,69568,5.9
1978,Jan,64.7,61,1187112,1119458,67654,5.7
1978,Feb,64.8,61.2,1191685,1125101,66584,5.6
1978,Mar,64.9,61.3,1196702,1130219,66483,5.6
1978,Apr,65,61.4,1202265,1135030,67235,5.6
1978,May,65.1,61.4,1208473,1139675,68798,5.7
1978,Jun,65.3,61.5,1215121,1144115,71006,5.8
1978,Jul,65.5,61.6,1221613,1148134,73479,6
1978,Aug,65.6,61.6,1227414,1151310,76104,6.2
1978,Sep,65.7,61.5,1232211,1153311,78900,6.4
1978,Oct,65.7,61.4,1235914,1154296,81618,6.6
1978,Nov,65.7,61.3,1238603,1154582,84021,6.8
1978,Dec,65.6,61.1,1240337,1154527,85810,6.9
1979,Jan,65.5,60.9,1241365,1154719,86646,7
1979,Feb,65.3,60.8,1242077,1155688,86389,7
1979,Mar,65.2,60.7,1243014,1157627,85387,6.9
1979,Apr,65.1,60.7,1244605,1160397,84208,6.8
1979,May,65.1,60.7,1246946,1163719,83227,6.7
1979,Jun,65.1,60.8,1249883,1167158,82725,6.6
1979,Jul,65.1,60.8,1253229,1170611,82618,6.6
1979,Aug,65.1,60.8,1256998,1174160,82838,6.6
1979,Sep,65.1,60.8,1261002,1177933,83069,6.6
1979,Oct,65.2,60.9,1264829,1182050,82779,6.5
1979,Nov,65.2,61,1268295,1186276,82019,6.5
1979,Dec,65.2,61,1271900,1189898,82002,6.4
1980,Jan,65.3,61,1276153,1192015,84138,6.6
1980,Feb,65.4,60.8,1281308,1192007,89301,7
1980,Mar,65.5,60.6,1287054,1189965,97089,7.5
1980,Apr,65.6,60.2,1292615,1186650,105965,8.2
1980,May,65.8,60,1297290,1183222,114068,8.8
1980,Jun,65.9,59.8,1300781,1180965,119816,9.2
1980,Jul,65.9,59.7,1303015,1180658,122357,9.4
1980,Aug,65.9,59.8,1304154,1182539,121615,9.3
1980,Sep,65.9,59.9,1305095,1186127,118968,9.1
1980,Oct,65.9,60,1307141,1190401,116740,8.9
1980,Nov,66,60.2,1310968,1194738,116230,8.9
1980,Dec,66.2,60.3,1316264,1199038,117226,8.9
1981,Jan,66.5,60.5,1322123,1202970,119153,9
1981,Feb,66.7,60.6,1327353,1206133,121220,9.1
1981,Mar,66.8,60.6,1331142,1208330,122812,9.2
1981,Apr,66.8,60.6,1333240,1209382,123858,9.3
1981,May,66.8,60.5,1333864,1209248,124616,9.3
1981,Jun,66.7,60.4,1333566,1208052,125514,9.4
1981,Jul,66.6,60.2,1333268,1205917,127351,9.6
1981,Aug,66.6,60.1,1333543,1202984,130559,9.8
1981,Sep,66.6,59.9,1334242,1199506,134736,10.1
1981,Oct,66.7,59.7,1334974,1195656,139318,10.4
1981,Nov,66.7,59.5,1335216,1191299,143917,10.8
1981,Dec,66.7,59.3,1334651,1186643,148008,11.1
1982,Jan,66.6,59.1,1333328,1182275,151053,11.3
1982,Feb,66.5,58.8,1331411,1178742,152669,11.5
1982,Mar,66.4,58.7,1329133,1176205,152928,11.5
1982,Apr,66.2,58.6,1326952,1174655,152297,11.5
1982,May,66.2,58.6,1325224,1173879,151345,11.4
1982,Jun,66.1,58.6,1324234,1173505,150729,11.4
1982,Jul,66.1,58.6,1324228,1173279,150949,11.4
1982,Aug,66.2,58.6,1325490,1173248,152242,11.5
1982,Sep,66.3,58.6,1328303,1173727,154576,11.6
1982,Oct,66.5,58.6,1332164,1175053,157111,11.8
1982,Nov,66.7,58.8,1336193,1177433,158760,11.9
1982,Dec,66.8,58.9,1339362,1180510,158852,11.9
1983,Jan,66.9,59,1340994,1183865,157129,11.7
1983,Feb,66.9,59.2,1341156,1187207,153949,11.5
1983,Mar,66.8,59.4,1340305,1190056,150249,11.2
1983,Apr,66.8,59.5,1338945,1192038,146907,11
1983,May,66.7,59.5,1337524,1192903,144621,10.8
1983,Jun,66.6,59.5,1336113,1192679,143434,10.7
1983,Jul,66.5,59.4,1334428,1191726,142702,10.7
1983,Aug,66.4,59.3,1332353,1190358,141995,10.7
1983,Sep,66.2,59.2,1329849,1189098,140751,10.6
1983,Oct,66,59.1,1327215,1188672,138543,10.4
1983,Nov,65.8,59.1,1325116,1189575,135541,10.2
1983,Dec,65.8,59.2,1324326,1191923,132403,10
1984,Jan,65.7,59.3,1325042,1195347,129695,9.8
1984,Feb,65.8,59.4,1326921,1199176,127745,9.6
1984,Mar,65.8,59.6,1329291,1202844,126447,9.5
1984,Apr,65.9,59.7,1331315,1205851,125464,9.4
1984,May,65.9,59.7,1332542,1207887,124655,9.4
1984,Jun,65.8,59.7,1332764,1208796,123968,9.3
1984,Jul,65.7,59.6,1332031,1208504,123527,9.3
1984,Aug,65.7,59.6,1330413,1207165,123248,9.3
1984,Sep,65.6,59.5,1328062,1204869,123193,9.3
1984,Oct,65.5,59.4,1325443,1201905,123538,9.3
1984,Nov,65.3,59.2,1323044,1198921,124123,9.4
1984,Dec,65.2,59.1,1321063,1196574,124489,9.4
1985,Jan,65.2,59,1319562,1195254,124308,9.4
1985,Feb,65.1,59,1318537,1194908,123629,9.4
1985,Mar,65.1,59.1,1317822,1195313,122509,9.3
1985,Apr,65.1,59.1,1317387,1196345,121042,9.2
1985,May,65.1,59.2,1317217,1198005,119212,9.1
1985,Jun,65.1,59.3,1317521,1200438,117083,8.9
1985,Jul,65.2,59.5,1318629,1203673,114956,8.7
1985,Aug,65.2,59.6,1320659,1207664,112995,8.6
1985,Sep,65.2,59.7,1323584,1212018,111566,8.4
1985,Oct,65.3,59.8,1327002,1216004,110998,8.4
1985,Nov,65.4,59.9,1330406,1218990,111416,8.4
1985,Dec,65.4,59.9,1333529,1220823,112706,8.5
1986,Jan,65.5,59.9,1336556,1222027,114529,8.6
1986,Feb,65.6,59.9,1339833,1223619,116214,8.7
1986,Mar,65.7,59.9,1343714,1226421,117293,8.7
1986,Apr,65.8,60.1,1348299,1230788,117511,8.7
1986,May,65.9,60.3,1353211,1236609,116602,8.6
1986,Jun,66.1,60.5,1357931,1243343,114588,8.4
1986,Jul,66.2,60.8,1361896,1250316,111580,8.2
1986,Aug,66.3,61,1364901,1256932,107969,7.9
1986,Sep,66.3,61.2,1366971,1262965,104006,7.6
1986,Oct,66.3,61.4,1368363,1268455,99908,7.3
1986,Nov,66.2,61.6,1369348,1273261,96087,7
1986,Dec,66.2,61.7,1370331,1277503,92828,6.8
1987,Jan,66.2,61.9,1371494,1281223,90271,6.6
1987,Feb,66.2,62,1372834,1284497,88337,6.4
1987,Mar,66.2,62.1,1374540,1287726,86814,6.3
1987,Apr,66.3,62.1,1376832,1291214,85618,6.2
1987,May,66.4,62.3,1380160,1295155,85005,6.2
1987,Jun,66.5,62.4,1384757,1299680,85077,6.1
1987,Jul,66.7,62.6,1390498,1304785,85713,6.2
1987,Aug,66.9,62.8,1396751,1310088,86663,6.2
1987,Sep,67.1,62.9,1402696,1315213,87483,6.2
1987,Oct,67.2,63,1407644,1319839,87805,6.2
1987,Nov,67.3,63.1,1411379,1324029,87350,6.2
1987,Dec,67.3,63.2,1414035,1327699,86336,6.1
1988,Jan,67.3,63.2,1415989,1330767,85222,6
1988,Feb,67.3,63.3,1417779,1333390,84389,6
1988,Mar,67.3,63.3,1419663,1335676,83987,5.9
1988,Apr,67.3,63.3,1421881,1337895,83986,5.9
1988,May,67.3,63.3,1424334,1340282,84052,5.9
1988,Jun,67.3,63.3,1426923,1343062,83861,5.9
1988,Jul,67.3,63.4,1429798,1346545,83253,5.8
1988,Aug,67.4,63.5,1433322,1351057,82265,5.7
1988,Sep,67.5,63.7,1437798,1356634,81164,5.6
1988,Oct,67.7,63.9,1443220,1363009,80211,5.6
1988,Nov,67.9,64.1,1449379,1369706,79673,5.5
1988,Dec,68.1,64.3,1455655,1376063,79592,5.5
1989,Jan,68.2,64.5,1461376,1381604,79772,5.5
1989,Feb,68.3,64.6,1465915,1385804,80111,5.5
1989,Mar,68.4,64.6,1469014,1388546,80468,5.5
1989,Apr,68.3,64.6,1470520,1389940,80580,5.5
1989,May,68.2,64.5,1470501,1390149,80352,5.5
1989,Jun,68.1,64.4,1469399,1389367,80032,5.4
1989,Jul,67.9,64.2,1467584,1387785,79799,5.4
1989,Aug,67.7,64,1465501,1386022,79479,5.4
1989,Sep,67.5,63.9,1463869,1384843,79026,5.4
1989,Oct,67.4,63.8,1463364,1384869,78495,5.4
1989,Nov,67.3,63.8,1464019,1386256,77763,5.3
1989,Dec,67.3,63.8,1465798,1388940,76858,5.2
1990,Jan,67.3,63.8,1468594,1392572,76022,5.2
1990,Feb,67.4,63.9,1472037,1396470,75567,5.1
1990,Mar,67.5,64.1,1475847,1400049,75798,5.1
1990,Apr,67.7,64.2,1480007,1403095,76912,5.2
1990,May,67.9,64.3,1484646,1405832,78814,5.3
1990,Jun,68.1,64.4,1489589,1408480,81109,5.4
1990,Jul,68.3,64.5,1494633,1411213,83420,5.6
1990,Aug,68.3,64.4,1499249,1413739,85510,5.7
1990,Sep,68.3,64.4,1502601,1415555,87046,5.8
1990,Oct,68.2,64.2,1504343,1416499,87844,5.8
1990,Nov,68.1,64.1,1505040,1416850,88190,5.9
1990,Dec,68,64,1505325,1416949,88376,5.9
1991,Jan,67.8,63.8,1505789,1417084,88705,5.9
1991,Feb,67.8,63.8,1507091,1417790,89301,5.9
1991,Mar,67.7,63.7,1509206,1419027,90179,6
1991,Apr,67.7,63.6,1511640,1420405,91235,6
1991,May,67.7,63.5,1514161,1421664,92497,6.1
1991,Jun,67.6,63.4,1516551,1422514,94037,6.2
1991,Jul,67.6,63.3,1518432,1422585,95847,6.3
1991,Aug,67.5,63.2,1520044,1421986,98058,6.5
1991,Sep,67.5,63,1522068,1421224,100844,6.6
1991,Oct,67.5,62.9,1524831,1420548,104283,6.8
1991,Nov,67.5,62.8,1528283,1420212,108071,7.1
1991,Dec,67.6,62.7,1532161,1420556,111605,7.3
1992,Jan,67.6,62.6,1536128,1421809,114319,7.4
1992,Feb,67.7,62.6,1539913,1423980,115933,7.5
1992,Mar,67.8,62.7,1543556,1427133,116423,7.5
1992,Apr,67.8,62.7,1547146,1431040,116106,7.5
1992,May,67.9,62.8,1550401,1435068,115333,7.4
1992,Jun,67.9,62.9,1553263,1438847,114416,7.4
1992,Jul,67.9,62.9,1556170,1442342,113828,7.3
1992,Aug,67.9,62.9,1559155,1445346,113809,7.3
1992,Sep,67.8,62.8,1561924,1447726,114198,7.3
1992,Oct,67.8,62.8,1564554,1449946,114608,7.3
1992,Nov,67.7,62.7,1567161,1452327,114834,7.3
1992,Dec,67.7,62.7,1569918,1454996,114922,7.3
1993,Jan,67.7,62.7,1573064,1458172,114892,7.3
1993,Feb,67.7,62.8,1576759,1461869,114890,7.3
1993,Mar,67.8,62.8,1581089,1466021,115068,7.3
1993,Apr,67.8,62.9,1586036,1470630,115406,7.3
1993,May,67.9,63,1591446,1475656,115790,7.3
1993,Jun,68,63.1,1597141,1481189,115952,7.3
1993,Jul,68.1,63.2,1602744,1487370,115374,7.2
1993,Aug,68.2,63.4,1608198,1494366,113832,7.1
1993,Sep,68.3,63.6,1613671,1502132,111539,6.9
1993,Oct,68.4,63.8,1618987,1510007,108980,6.7
1993,Nov,68.5,64,1623749,1517234,106515,6.6
1993,Dec,68.6,64.2,1627758,1523579,104179,6.4
1994,Jan,68.6,64.3,1631066,1529150,101916,6.2
1994,Feb,68.6,64.4,1633744,1534216,99528,6.1
1994,Mar,68.6,64.5,1636198,1539262,96936,5.9
1994,Apr,68.6,64.7,1639000,1544757,94243,5.8
1994,May,68.7,64.8,1642396,1550817,91579,5.6
1994,Jun,68.7,65,1646239,1557072,89167,5.4
1994,Jul,68.8,65.1,1650145,1562961,87184,5.3
1994,Aug,68.8,65.2,1653462,1567959,85503,5.2
1994,Sep,68.8,65.3,1655792,1571824,83968,5.1
1994,Oct,68.7,65.2,1657124,1574818,82306,5
1994,Nov,68.6,65.3,1657967,1577490,80477,4.9
1994,Dec,68.5,65.3,1658830,1579878,78952,4.8
1995,Jan,68.4,65.2,1659955,1581769,78186,4.7
1995,Feb,68.4,65.2,1661573,1583301,78272,4.7
1995,Mar,68.4,65.1,1663676,1584604,79072,4.8
1995,Apr,68.3,65.1,1665880,1585710,80170,4.8
1995,May,68.3,65,1668127,1586973,81154,4.9
1995,Jun,68.3,65,1670402,1588627,81775,4.9
1995,Jul,68.3,64.9,1672732,1590648,82084,4.9
1995,Aug,68.3,64.9,1675245,1592912,82333,4.9
1995,Sep,68.3,64.9,1678210,1595277,82933,4.9
1995,Oct,68.3,64.8,1681904,1597670,84234,5
1995,Nov,68.3,64.8,1686419,1600190,86229,5.1
1995,Dec,68.4,64.8,1691764,1603112,88652,5.2
1996,Jan,68.5,64.9,1697759,1606620,91139,5.4
1996,Feb,68.7,64.9,1703991,1610539,93452,5.5
1996,Mar,68.8,65,1709889,1614513,95376,5.6
1996,Apr,68.9,65,1714936,1618206,96730,5.6
1996,May,68.9,65,1718792,1621309,97483,5.7
1996,Jun,68.9,65,1721491,1623694,97797,5.7
1996,Jul,68.8,64.9,1723500,1625452,98048,5.7
1996,Aug,68.8,64.9,1725358,1626753,98605,5.7
1996,Sep,68.8,64.8,1727173,1627661,99512,5.8
1996,Oct,68.7,64.7,1728940,1628194,100746,5.8
1996,Nov,68.7,64.6,1730731,1628489,102242,5.9
1996,Dec,68.7,64.6,1732423,1628959,103464,6
1997,Jan,68.6,64.5,1733936,1630045,103891,6
1997,Feb,68.6,64.5,1735434,1632039,103395,6
1997,Mar,68.6,64.6,1737199,1635118,102081,5.9
1997,Apr,68.6,64.6,1739713,1639208,100505,5.8
1997,May,68.6,64.7,1743065,1643904,99161,5.7
1997,Jun,68.7,64.9,1747119,1648876,98243,5.6
1997,Jul,68.8,65,1751600,1653969,97631,5.6
1997,Aug,68.9,65.1,1756214,1658898,97316,5.5
1997,Sep,69,65.2,1760545,1663401,97144,5.5
1997,Oct,69,65.2,1764205,1667291,96914,5.5
1997,Nov,69,65.3,1766904,1670359,96545,5.5
1997,Dec,69,65.3,1768862,1672600,96262,5.4
1998,Jan,69,65.3,1770527,1674112,96415,5.4
1998,Feb,69,65.2,1772139,1675041,97098,5.5
1998,Mar,69,65.2,1773623,1675421,98202,5.5
1998,Apr,69,65.1,1775068,1675535,99533,5.6
1998,May,68.9,65,1776723,1675764,100959,5.7
1998,Jun,69,65,1778638,1676250,102388,5.8
1998,Jul,68.9,64.9,1780684,1676948,103736,5.8
1998,Aug,68.9,64.9,1782869,1678055,104814,5.9
1998,Sep,68.9,64.9,1785222,1679691,105531,5.9
1998,Oct,69,64.9,1787608,1681759,105849,5.9
1998,Nov,69,64.9,1789582,1683942,105640,5.9
1998,Dec,68.9,64.9,1790604,1685719,104885,5.9
1999,Jan,68.8,64.9,1790387,1686743,103644,5.8
1999,Feb,68.8,64.8,1789311,1687075,102236,5.7
1999,Mar,68.7,64.8,1788109,1687062,101047,5.7
1999,Apr,68.5,64.7,1787253,1686947,100306,5.6
1999,May,68.5,64.6,1787032,1687003,100029,5.6
1999,Jun,68.4,64.6,1787814,1687821,99993,5.6
1999,Jul,68.4,64.6,1789877,1690024,99853,5.6
1999,Aug,68.5,64.7,1792996,1693801,99195,5.5
1999,Sep,68.6,64.8,1796727,1698887,97840,5.4
1999,Oct,68.7,65,1800666,1704716,95950,5.3
1999,Nov,68.7,65.2,1804602,1710759,93843,5.2
1999,Dec,68.8,65.3,1808519,1716481,92038,5.1
2000,Jan,68.9,65.5,1812342,1721397,90945,5
2000,Feb,69,65.5,1815669,1725101,90568,5
2000,Mar,69.1,65.6,1818372,1727424,90948,5
2000,Apr,69.1,65.6,1820366,1728525,91841,5
2000,May,69.1,65.6,1821537,1728646,92891,5.1
2000,Jun,69,65.5,1821849,1727952,93897,5.2
2000,Jul,68.9,65.4,1821305,1726726,94579,5.2
2000,Aug,68.8,65.2,1820228,1725568,94660,5.2
2000,Sep,68.7,65.1,1819174,1724976,94198,5.2
2000,Oct,68.6,65,1818581,1725040,93541,5.1
2000,Nov,68.5,65,1818641,1725324,93317,5.1
2000,Dec,68.4,64.9,1819199,1725189,94010,5.2
2001,Jan,68.4,64.8,1819942,1724172,95770,5.3
2001,Feb,68.3,64.6,1820696,1722186,98510,5.4
2001,Mar,68.3,64.4,1821160,1719391,101769,5.6
2001,Apr,68.2,64.3,1821270,1716061,105209,5.8
2001,May,68.1,64,1821401,1712690,108711,6
2001,Jun,68,63.8,1821711,1709409,112302,6.2
2001,Jul,68,63.6,1822500,1706103,116397,6.4
2001,Aug,67.9,63.4,1823859,1702353,121506,6.7
2001,Sep,67.9,63.2,1825725,1698122,127603,7
2001,Oct,67.9,62.9,1827828,1693870,133958,7.3
2001,Nov,67.9,62.7,1829757,1690130,139627,7.6
2001,Dec,67.8,62.5,1831234,1687561,143673,7.8
2002,Jan,67.8,62.4,1832007,1686515,145492,7.9
2002,Feb,67.7,62.3,1832050,1686953,145097,7.9
2002,Mar,67.6,62.3,1831656,1688681,142975,7.8
2002,Apr,67.5,62.4,1831456,1691574,139882,7.6
2002,May,67.5,62.4,1831972,1695253,136719,7.5
2002,Jun,67.4,62.5,1833461,1699185,134276,7.3
2002,Jul,67.4,62.5,1835482,1702519,132963,7.2
2002,Aug,67.4,62.5,1837468,1704680,132788,7.2
2002,Sep,67.4,62.5,1839017,1705455,133562,7.3
2002,Oct,67.3,62.4,1839921,1704859,135062,7.3
2002,Nov,67.3,62.3,1840528,1703388,137140,7.5
2002,Dec,67.2,62.1,1841232,1701484,139748,7.6
2003,Jan,67.2,62,1842582,1699599,142983,7.8
2003,Feb,67.2,61.9,1844794,1698052,146742,8
2003,Mar,67.3,61.8,1847374,1696796,150578,8.2
2003,Apr,67.3,61.7,1849429,1695506,153923,8.3
2003,May,67.3,61.6,1850178,1694048,156130,8.4
2003,Jun,67.2,61.5,1849561,1692884,156677,8.5
2003,Jul,67,61.4,1847906,1692585,155321,8.4
2003,Aug,66.9,61.4,1845741,1693156,152585,8.3
2003,Sep,66.8,61.4,1843551,1694219,149332,8.1
2003,Oct,66.6,61.3,1841925,1695400,146525,8
2003,Nov,66.6,61.3,1841081,1696494,144587,7.9
2003,Dec,66.5,61.3,1840807,1697498,143309,7.8
2004,Jan,66.5,61.3,1840722,1698415,142307,7.7
2004,Feb,66.4,61.3,1840477,1699336,141141,7.7
2004,Mar,66.4,61.3,1840126,1700408,139718,7.6
2004,Apr,66.3,61.3,1839668,1701600,138068,7.5
2004,May,66.2,61.3,1839064,1702683,136381,7.4
2004,Jun,66.2,61.3,1838295,1703377,134918,7.3
2004,Jul,66.1,61.3,1837518,1703725,133793,7.3
2004,Aug,66,61.2,1836747,1704109,132638,7.2
2004,Sep,65.8,61.1,1835975,1704944,131031,7.1
2004,Oct,65.7,61.1,1835218,1706460,128758,7
2004,Nov,65.6,61.1,1834584,1708718,125866,6.9
2004,Dec,65.5,61.2,1834547,1711650,122897,6.7
2005,Jan,65.5,61.2,1835301,1715069,120232,6.6
2005,Feb,65.5,61.3,1836728,1718590,118138,6.4
2005,Mar,65.5,61.3,1838672,1721969,116703,6.3
2005,Apr,65.5,61.3,1841007,1725152,115855,6.3
2005,May,65.5,61.4,1843557,1728180,115377,6.3
2005,Jun,65.5,61.4,1845977,1730974,115003,6.2
2005,Jul,65.5,61.4,1847975,1733417,114558,6.2
2005,Aug,65.4,61.4,1849499,1735673,113826,6.2
2005,Sep,65.3,61.4,1850744,1738105,112639,6.1
2005,Oct,65.2,61.3,1851942,1741082,110860,6
2005,Nov,65.2,61.3,1853367,1744788,108579,5.9
2005,Dec,65.1,61.4,1855220,1749274,105946,5.7
2006,Jan,65.1,61.5,1857859,1754562,103297,5.6
2006,Feb,65.1,61.6,1861515,1760467,101048,5.4
2006,Mar,65.2,61.7,1866141,1766594,99547,5.3
2006,Apr,65.3,61.9,1871463,1772508,98955,5.3
2006,May,65.4,62,1877083,1778011,99072,5.3
2006,Jun,65.5,62,1882716,1783078,99638,5.3
2006,Jul,65.6,62.1,1888391,1787997,100394,5.3
2006,Aug,65.7,62.2,1894109,1792971,101138,5.3
2006,Sep,65.8,62.3,1899606,1797971,101635,5.4
2006,Oct,65.9,62.3,1904557,1803012,101545,5.3
2006,Nov,65.9,62.4,1908554,1807825,100729,5.3
2006,Dec,65.9,62.5,1911215,1811899,99316,5.2
2007,Jan,65.9,62.5,1912583,1814953,97630,5.1
2007,Feb,65.8,62.5,1913074,1816978,96096,5
2007,Mar,65.7,62.4,1913143,1818080,95063,5
2007,Apr,65.6,62.4,1913478,1818658,94820,5
2007,May,65.6,62.3,1914721,1819134,95587,5
2007,Jun,65.6,62.2,1917102,1819931,97171,5.1
2007,Jul,65.6,62.2,1920437,1821293,99144,5.2
2007,Aug,65.6,62.2,1924484,1823343,101141,5.3
2007,Sep,65.7,62.2,1928783,1826072,102711,5.3
2007,Oct,65.7,62.2,1932674,1829114,103560,5.4
2007,Nov,65.7,62.2,1935658,1832157,103501,5.3
2007,Dec,65.7,62.2,1937575,1834933,102642,5.3
2008,Jan,65.7,62.2,1938430,1836937,101493,5.2
2008,Feb,65.6,62.2,1938848,1838003,100845,5.2
2008,Mar,65.6,62.1,1939841,1838295,101546,5.2
2008,Apr,65.6,62.1,1941983,1837880,104103,5.4
2008,May,65.6,62,1945509,1836911,108598,5.6
2008,Jun,65.7,61.8,1950369,1835401,114968,5.9
2008,Jul,65.8,61.7,1955947,1833034,122913,6.3
2008,Aug,65.9,61.5,1961436,1829264,132172,6.7
2008,Sep,66,61.2,1966533,1823527,143006,7.3
2008,Oct,66.1,60.9,1971342,1815456,155886,7.9
2008,Nov,66.2,60.4,1976033,1805112,170921,8.6
2008,Dec,66.3,60,1980678,1793258,187420,9.5
2009,Jan,66.3,59.5,1984958,1781050,203908,10.3
2009,Feb,66.4,59.1,1988297,1769890,218407,11
2009,Mar,66.4,58.8,1990031,1761005,229026,11.5
2009,Apr,66.3,58.5,1989740,1754948,234792,11.8
2009,May,66.2,58.3,1987185,1751282,235903,11.9
2009,Jun,65.9,58.2,1982474,1749219,233255,11.8
2009,Jul,65.7,58.1,1976412,1747976,228436,11.6
2009,Aug,65.4,58,1970264,1747036,223228,11.3
2009,Sep,65.2,57.9,1965187,1746364,218823,11.1
2009,Oct,65,57.8,1962001,1746163,215838,11
2009,Nov,64.9,57.8,1961392,1746925,214467,10.9
2009,Dec,64.9,57.8,1963411,1748959,214452,10.9
2010,Jan,65,57.9,1967463,1752287,215176,10.9
2010,Feb,65.1,58,1972219,1756351,215868,10.9
2010,Mar,65.2,58.1,1976473,1760547,215926,10.9
2010,Apr,65.5,58.3,1979679,1764584,215095,10.9
2010,May,65.5,58.4,1981748,1768359,213389,10.8
2010,Jun,65.5,58.5,1983223,1771808,211415,10.7
2010,Jul,65.5,58.5,1984774,1774965,209809,10.6
2010,Aug,65.4,58.6,1986782,1778138,208644,10.5
2010,Sep,65.5,58.6,1989230,1781560,207670,10.4
2010,Oct,65.5,58.7,1991833,1785539,206294,10.4
2010,Nov,65.5,58.8,1994009,1790046,203963,10.2
2010,Dec,65.5,58.9,1995337,1794730,200607,10.1
2011,Jan,65.4,59,1995928,1799192,196736,9.9
2011,Feb,65.4,59,1995957,1802805,193152,9.7
2011,Mar,65.3,59.1,1995613,1805065,190548,9.5
2011,Apr,65.2,59,1995145,1805872,189273,9.5
2011,May,65.1,59,1994847,1805535,189312,9.5
2011,Jun,65.1,58.9,1994642,1804653,189989,9.5
2011,Jul,65,58.8,1994457,1804031,190426,9.5
2011,Aug,64.9,58.7,1994112,1803997,190115,9.5
2011,Sep,64.8,58.7,1993268,1804394,188874,9.5
2011,Oct,64.7,58.7,1991813,1804859,186954,9.4
2011,Nov,64.6,58.6,1989605,1804848,184757,9.3
2011,Dec,64.5,58.5,1986580,1804002,182578,9.2
2012,Jan,64.3,58.4,1982713,1802207,180506,9.1
2012,Feb,64.1,58.3,1978231,1799565,178666,9
2012,Mar,63.9,58.2,1973317,1796114,177203,9
2012,Apr,63.7,58,1967875,1791931,175944,8.9
2012,May,63.4,57.8,1962194,1787555,174639,8.9
2012,Jun,63.2,57.6,1956474,1783319,173155,8.9
2012,Jul,63,57.4,1950606,1779137,171469,8.8
2012,Aug,62.7,57.2,1944745,1774907,169838,8.7
2012,Sep,62.5,57.1,1939239,1770720,168519,8.7
2012,Oct,62.3,56.9,1933900,1766539,167361,8.7
2012,Nov,62,56.7,1928581,1762465,166116,8.6
2012,Dec,61.8,56.5,1923380,1758815,164565,8.6
2013,Jan,61.6,56.4,1918564,1755911,162653,8.5
2013,Feb,61.5,56.3,1914533,1754171,160362,8.4
2013,Mar,61.3,56.3,1911585,1753830,157755,8.3
2013,Apr,61.3,56.3,1909970,1754910,155060,8.1
2013,May,61.2,56.3,1909278,1756713,152565,8
2013,Jun,61.1,56.3,1908985,1758586,150399,7.9
2013,Jul,61.1,56.3,1908801,1760355,148446,7.8
2013,Aug,61,56.3,1908410,1762092,146318,7.7
2013,Sep,60.9,56.3,1907949,1763894,144055,7.6
2013,Oct,60.9,56.3,1908135,1765905,142230,7.5
2013,Nov,60.8,56.3,1909513,1768430,141083,7.4
2013,Dec,60.9,56.4,1912046,1771555,140491,7.3
2014,Jan,61,56.5,1917578,1776888,140690,7.3
2014,Feb,61.1,56.6,1921448,1781627,139821,7.3
2014,Mar,61.1,56.7,1925161,1786730,138431,7.2
2014,Apr,61.2,56.8,1928463,1791853,136610,7.1
2014,May,61.2,56.9,1931550,1797101,134449,7
2014,Jun,61.2,57.1,1934959,1802732,132227,6.8
2014,Jul,61.3,57.2,1938696,1808486,130210,6.7
2014,Aug,61.3,57.3,1942628,1814176,128452,6.6
2014,Sep,61.4,57.4,1946418,1819691,126727,6.5
2014,Oct,61.4,57.5,1949453,1824864,124589,6.4
2014,Nov,61.4,57.5,1951316,1829375,121941,6.2
2014,Dec,61.3,57.6,1952579,1833334,119245,6.1
2015,Jan,61.3,57.6,1953568,1836649,116919,6
2015,Feb,61.3,57.7,1955891,1840534,115357,5.9
2015,Mar,61.3,57.7,1959313,1844888,114425,5.8
2015,Apr,61.4,57.8,1963714,1849906,113808,5.8
2015,May,61.5,57.9,1968658,1855485,113173,5.7
2015,Jun,61.5,58,1973643,1861429,112214,5.7
2015,Jul,61.6,58.1,1978665,1867764,110901,5.6
2015,Aug,61.6,58.2,1983882,1874540,109342,5.5
2015,Sep,61.7,58.4,1989537,1881908,107629,5.4
2015,Oct,61.8,58.5,1996251,1890275,105976,5.3
2015,Nov,61.9,58.7,2004236,1899646,104590,5.2
2015,Dec,62.1,58.9,2012757,1909296,103461,5.1
2016,Jan,62.2,59.1,2020960,1918358,102602,5.1
2016,Feb,62.4,59.2,2028317,1926180,102137,5
2016,Mar,62.4,59.3,2034536,1932529,102007,5
2016,Apr,62.5,59.4,2039723,1937623,102100,5
2016,May,62.5,59.4,2044195,1942015,102180,5
2016,Jun,62.5,59.4,2048199,1946308,101891,5
2016,Jul,62.5,59.5,2051899,1951011,100888,4.9
2016,Aug,62.5,59.5,2055195,1956069,99126,4.8
2016,Sep,62.5,59.6,2057956,1961147,96809,4.7
2016,Oct,62.5,59.7,2060099,1965957,94142,4.6
2016,Nov,62.5,59.7,2062092,1970720,91372,4.4
2016,Dec,62.5,59.8,2064658,1975823,88835,4.3
2017,Jan,62.5,59.9,2068179,1981334,86845,4.2
2017,Feb,62.6,60,2072672,1987188,85484,4.1
2017,Mar,62.7,60.1,2077839,1993011,84828,4.1
2017,Apr,62.8,60.2,2083300,1998465,84835,4.1
2017,May,62.8,60.3,2088485,2003240,85245,4.1
2017,Jun,62.9,60.3,2092727,2006925,85802,4.1
2017,Jul,62.9,60.3,2095682,2009373,86309,4.1
2017,Aug,62.9,60.3,2097392,2010789,86603,4.1
2017,Sep,62.8,60.2,2098221,2011532,86689,4.1
2017,Oct,62.8,60.2,2098442,2011793,86649,4.1
2017,Nov,62.7,60.1,2098180,2011586,86594,4.1
2017,Dec,62.6,60,2097630,2011131,86499,4.1
2018,Jan,62.5,60,2097096,2010773,86323,4.1
2018,Feb,62.5,59.9,2096731,2010720,86011,4.1
2018,Mar,62.4,59.9,2096318,2010909,85409,4.1
2018,Apr,62.3,59.8,2095429,2010989,84440,4
2018,May,62.2,59.8,2094131,2010772,83359,4
2018,Jun,62.1,59.7,2093119,2010549,82570,3.9
2018,Jul,62.1,59.6,2092913,2010555,82358,3.9
2018,Aug,62,59.6,2094044,2011103,82941,4
2018,Sep,62,59.6,2096605,2012385,84220,4
2018,Oct,62.1,59.5,2100148,2014284,85864,4.1
2018,Nov,62.1,59.6,2103843,2016433,87410,4.2
2018,Dec,62.2,59.6,2106704,2018316,88388,4.2
2019,Jan,62.2,59.5,2107966,2019483,88483,4.2
2019,Feb,62.1,59.5,2107405,2019776,87629,4.2
2019,Mar,62,59.5,2105727,2019569,86158,4.1
2019,Apr,61.9,59.4,2103937,2019541,84396,4
2019,May,61.8,59.4,2102670,2020170,82500,3.9
2019,Jun,61.7,59.4,2102160,2021645,80515,3.8
2019,Jul,61.7,59.4,2102460,2024262,78198,3.7
2019,Aug,61.6,59.4,2102758,2027120,75638,3.6
2019,Sep,61.5,59.4,2103078,2029880,73198,3.5
2019,Oct,61.5,59.4,2103183,2031830,71353,3.4
2019,Nov,61.4,59.4,2103089,2032001,71088,3.4
2019,Dec,61.4,59.3,2103105,2031743,71362,3.4
2020,Jan,61.4,59.3,2104158,2034344,69814,3.3
2020,Feb,61.3,59.3,2105508,2036466,69042,3.3
2020,Mar,61.5,59.3,2110900,2038010,72890,3.5
2020,Apr,61.4,52.3,2110693,1796681,314012,14.9
2020,May,61.7,52.9,2124082,1820588,303494,14.3
2020,Jun,62.7,55.4,2159459,1909526,249933,11.6
2020,Jul,59.8,53.6,2061771,1846582,215189,10.4
2020,Aug,60,54.9,2072012,1895367,176645,8.5
2020,Sep,59.6,54.8,2058880,1893832,165048,8
