Year,Period,labor force participation rate,employment-population ratio,labor force,employment,unemployment,unemployment rate
1976,Jan,67.3,63.6,1232334,1164563,67771,5.5
1976,Feb,67.1,63.4,1232109,1164631,67478,5.5
1976,Mar,66.9,63.3,1231539,1164628,66911,5.4
1976,Apr,66.7,63.1,1231011,1164119,66892,5.4
1976,May,66.5,62.9,1231050,1163412,67638,5.5
1976,Jun,66.4,62.7,1232568,1163342,69226,5.6
1976,Jul,66.5,62.6,1235853,1164288,71565,5.8
1976,Aug,66.5,62.6,1240888,1166968,73920,6
1976,Sep,66.7,62.6,1247308,1171424,75884,6.1
1976,Oct,66.9,62.7,1254476,1176908,77568,6.2
1976,Nov,67.1,62.9,1261663,1182382,79281,6.3
1976,Dec,67.2,62.9,1268361,1187185,81176,6.4
1977,Jan,67.4,63,1274428,1191307,83121,6.5
1977,Feb,67.4,63,1279809,1195055,84754,6.6
1977,Mar,67.4,62.9,1284126,1198433,85693,6.7
1977,Apr,67.4,62.9,1287111,1201482,85629,6.7
1977,May,67.3,62.9,1288954,1204375,84579,6.6
1977,Jun,67.2,62.9,1290346,1207360,82986,6.4
1977,Jul,67.1,62.9,1291967,1210767,81200,6.3
1977,Aug,67,62.9,1294796,1214718,80078,6.2
1977,Sep,67,62.9,1298913,1219060,79853,6.1
1977,Oct,67.1,62.9,1303489,1223548,79941,6.1
1977,Nov,67.1,63,1308177,1228044,80133,6.1
1977,Dec,67.1,63,1312573,1232406,80167,6.1
1978,Jan,67.2,63.1,1316933,1237025,79908,6.1
1978,Feb,67.2,63.2,1321494,1242209,79285,6
1978,Mar,67.2,63.3,1326486,1248085,78401,5.9
1978,Apr,67.3,63.4,1332018,1254611,77407,5.8
1978,May,67.4,63.6,1337972,1261586,76386,5.7
1978,Jun,67.5,63.7,1344064,1268812,75252,5.6
1978,Jul,67.6,63.9,1350043,1275960,74083,5.5
1978,Aug,67.7,64,1355843,1283026,72817,5.4
1978,Sep,67.8,64.2,1361886,1290402,71484,5.2
1978,Oct,67.9,64.4,1368817,1298426,70391,5.1
1978,Nov,68,64.6,1376217,1306875,69342,5
1978,Dec,68.2,64.8,1383534,1315057,68477,4.9
1979,Jan,68.3,65,1390268,1322425,67843,4.9
1979,Feb,68.4,65.1,1396441,1329204,67237,4.8
1979,Mar,68.4,65.2,1402704,1336013,66691,4.8
1979,Apr,68.6,65.3,1409605,1343293,66312,4.7
1979,May,68.7,65.5,1417528,1351293,66235,4.7
1979,Jun,68.9,65.7,1426110,1359527,66583,4.7
1979,Jul,69.1,65.9,1434777,1367521,67256,4.7
1979,Aug,69.4,66.1,1442967,1374884,68083,4.7
1979,Sep,69.6,66.3,1450186,1381319,68867,4.7
1979,Oct,69.7,66.4,1456190,1386935,69255,4.8
1979,Nov,69.8,66.5,1461281,1392049,69232,4.7
1979,Dec,69.9,66.6,1465918,1396744,69174,4.7
1980,Jan,69.9,66.6,1470282,1400615,69667,4.7
1980,Feb,70,66.6,1474693,1403225,71468,4.8
1980,Mar,70.1,66.5,1479234,1404421,74813,5.1
1980,Apr,70.2,66.4,1483866,1404408,79458,5.4
1980,May,70.2,66.2,1488455,1403676,84779,5.7
1980,Jun,70.3,66,1492946,1403093,89853,6
1980,Jul,70.3,65.9,1496909,1403211,93698,6.3
1980,Aug,70.2,65.8,1499791,1404052,95739,6.4
1980,Sep,70.2,65.7,1501571,1405392,96179,6.4
1980,Oct,70.1,65.6,1502766,1407086,95680,6.4
1980,Nov,70,65.6,1504370,1409635,94735,6.3
1980,Dec,69.9,65.6,1507387,1413846,93541,6.2
1981,Jan,70,65.7,1512057,1419683,92374,6.1
1981,Feb,70.1,65.9,1517779,1426473,91306,6
1981,Mar,70.2,66.1,1523894,1433733,90161,5.9
1981,Apr,70.3,66.2,1529691,1440865,88826,5.8
1981,May,70.4,66.4,1534706,1447378,87328,5.7
1981,Jun,70.4,66.5,1539179,1453271,85908,5.6
1981,Jul,70.5,66.6,1543378,1458368,85010,5.5
1981,Aug,70.5,66.6,1547326,1462438,84888,5.5
1981,Sep,70.4,66.6,1550975,1465458,85517,5.5
1981,Oct,70.4,66.5,1554417,1467451,86966,5.6
1981,Nov,70.4,66.3,1557569,1468285,89284,5.7
1981,Dec,70.3,66.2,1560750,1468509,92241,5.9
1982,Jan,70.3,66,1564617,1469226,95391,6.1
1982,Feb,70.4,66,1569426,1470844,98582,6.3
1982,Mar,70.4,65.9,1574902,1472976,101926,6.5
1982,Apr,70.5,65.8,1580754,1475259,105495,6.7
1982,May,70.6,65.7,1586554,1477143,109411,6.9
1982,Jun,70.7,65.6,1591901,1478035,113866,7.2
1982,Jul,70.7,65.4,1597137,1478225,118912,7.4
1982,Aug,70.8,65.3,1602990,1478674,124316,7.8
1982,Sep,70.9,65.2,1609769,1480290,129479,8
1982,Oct,71.1,65.2,1617248,1483618,133630,8.3
1982,Nov,71.3,65.3,1625129,1488723,136406,8.4
1982,Dec,71.5,65.4,1632599,1494818,137781,8.4
1983,Jan,71.6,65.6,1639050,1501103,137947,8.4
1983,Feb,71.7,65.7,1644532,1507559,136973,8.3
1983,Mar,71.7,65.8,1649261,1514401,134860,8.2
1983,Apr,71.8,66,1653847,1522058,131789,8
1983,May,71.8,66.3,1658779,1530935,127844,7.7
1983,Jun,71.9,66.6,1664075,1541146,122929,7.4
1983,Jul,72,66.9,1669571,1552358,117213,7
1983,Aug,72.1,67.3,1674946,1563625,111321,6.6
1983,Sep,72.2,67.7,1680008,1574097,105911,6.3
1983,Oct,72.3,68,1684607,1583321,101286,6
1983,Nov,72.4,68.2,1688556,1591133,97423,5.8
1983,Dec,72.5,68.4,1692143,1597834,94309,5.6
1984,Jan,72.5,68.6,1696023,1604104,91919,5.4
1984,Feb,72.6,68.8,1700759,1610440,90319,5.3
1984,Mar,72.8,68.9,1706458,1616774,89684,5.3
1984,Apr,72.9,69.1,1712367,1622497,89870,5.2
1984,May,73.1,69.2,1717658,1626959,90699,5.3
1984,Jun,73.1,69.2,1721634,1629608,92026,5.3
1984,Jul,73.1,69.2,1723818,1630318,93500,5.4
1984,Aug,73.1,69,1724187,1629445,94742,5.5
1984,Sep,73,68.9,1723211,1627493,95718,5.6
1984,Oct,72.8,68.7,1721986,1625342,96644,5.6
1984,Nov,72.7,68.6,1721564,1623963,97601,5.7
1984,Dec,72.7,68.5,1722093,1623632,98461,5.7
1985,Jan,72.6,68.5,1722807,1623644,99163,5.8
1985,Feb,72.5,68.3,1722632,1622934,99698,5.8
1985,Mar,72.4,68.2,1721147,1620944,100203,5.8
1985,Apr,72.2,68,1718774,1617849,100925,5.9
1985,May,72,67.8,1716098,1614157,101941,5.9
1985,Jun,71.9,67.5,1713649,1610470,103179,6
1985,Jul,71.7,67.3,1711664,1607163,104501,6.1
1985,Aug,71.6,67.1,1710437,1604806,105631,6.2
1985,Sep,71.5,67,1709944,1603416,106528,6.2
1985,Oct,71.4,66.9,1709530,1602138,107392,6.3
1985,Nov,71.3,66.8,1708654,1600114,108540,6.4
1985,Dec,71.1,66.5,1707249,1596926,110323,6.5
1986,Jan,71,66.3,1705714,1592932,112782,6.6
1986,Feb,70.9,66.1,1704681,1588996,115685,6.8
1986,Mar,70.8,65.8,1704190,1585654,118536,7
1986,Apr,70.7,65.7,1703943,1582888,121055,7.1
1986,May,70.6,65.5,1703874,1580475,123399,7.2
1986,Jun,70.6,65.4,1704135,1578275,125860,7.4
1986,Jul,70.5,65.2,1704815,1576033,128782,7.6
1986,Aug,70.5,65,1705738,1573519,132219,7.8
1986,Sep,70.5,64.9,1706673,1570968,135705,8
1986,Oct,70.5,64.7,1707589,1568878,138711,8.1
1986,Nov,70.4,64.6,1708212,1567304,140908,8.2
1986,Dec,70.4,64.5,1708562,1566539,142023,8.3
1987,Jan,70.3,64.5,1708446,1566483,141963,8.3
1987,Feb,70.3,64.5,1707370,1566626,140744,8.2
1987,Mar,70.1,64.4,1705414,1566918,138496,8.1
1987,Apr,70,64.4,1702816,1567436,135380,8
1987,May,69.8,64.4,1699924,1568279,131645,7.7
1987,Jun,69.7,64.4,1697373,1569583,127790,7.5
1987,Jul,69.5,64.4,1695845,1571576,124269,7.3
1987,Aug,69.5,64.5,1695738,1574129,121609,7.2
1987,Sep,69.6,64.6,1697164,1577023,120141,7.1
1987,Oct,69.6,64.7,1699581,1579870,119711,7
1987,Nov,69.7,64.8,1702207,1582433,119774,7
1987,Dec,69.8,64.9,1704007,1584252,119755,7
1988,Jan,69.8,64.9,1704329,1585136,119193,7
1988,Feb,69.7,64.9,1703519,1585551,117968,6.9
1988,Mar,69.6,64.9,1702169,1585775,116394,6.8
1988,Apr,69.6,64.9,1700919,1586045,114874,6.8
1988,May,69.5,64.9,1700062,1586547,113515,6.7
1988,Jun,69.5,64.9,1699374,1587186,112188,6.6
1988,Jul,69.4,64.9,1698386,1587729,110657,6.5
1988,Aug,69.3,64.9,1696657,1587964,108693,6.4
1988,Sep,69.2,64.8,1694097,1587768,106329,6.3
1988,Oct,69,64.8,1691004,1587220,103784,6.1
1988,Nov,68.9,64.7,1687969,1586577,101392,6
1988,Dec,68.7,64.7,1685520,1586067,99453,5.9
1989,Jan,68.6,64.6,1684245,1586092,98153,5.8
1989,Feb,68.6,64.6,1684232,1586753,97479,5.8
1989,Mar,68.6,64.7,1685541,1588488,97053,5.8
1989,Apr,68.7,64.8,1688108,1591591,96517,5.7
1989,May,68.8,64.9,1691793,1595907,95886,5.7
1989,Jun,69,65.1,1696528,1601194,95334,5.6
1989,Jul,69.2,65.3,1701988,1606883,95105,5.6
1989,Aug,69.4,65.5,1707760,1612545,95215,5.6
1989,Sep,69.6,65.7,1713449,1618094,95355,5.6
1989,Oct,69.7,65.9,1719132,1623891,95241,5.5
1989,Nov,69.9,66.1,1724800,1630010,94790,5.5
1989,Dec,70.1,66.3,1730593,1636478,94115,5.4
1990,Jan,69.9,66.1,1736587,1643233,93354,5.4
1990,Feb,70.1,66.4,1742520,1649883,92637,5.3
1990,Mar,70.4,66.7,1748100,1655884,92216,5.3
1990,Apr,70.6,66.9,1753317,1661077,92240,5.3
1990,May,70.8,67.1,1758442,1665862,92580,5.3
1990,Jun,71,67.3,1763323,1670386,92937,5.3
1990,Jul,71.3,67.5,1768034,1675050,92984,5.3
1990,Aug,71.3,67.6,1772470,1679890,92580,5.2
1990,Sep,71.3,67.6,1776112,1684219,91893,5.2
1990,Oct,71.2,67.6,1778443,1687317,91126,5.1
1990,Nov,71.1,67.5,1779758,1689400,90358,5.1
1990,Dec,71,67.4,1780570,1690906,89664,5
1991,Jan,70.9,67.3,1781282,1692047,89235,5
1991,Feb,70.8,67.3,1782769,1693527,89242,5
1991,Mar,70.8,67.2,1785107,1695439,89668,5
1991,Apr,70.7,67.2,1788000,1697598,90402,5.1
1991,May,70.7,67.1,1791139,1699798,91341,5.1
1991,Jun,70.7,67.1,1794282,1701828,92454,5.2
1991,Jul,70.6,67,1796970,1703204,93766,5.2
1991,Aug,70.6,66.8,1799120,1703810,95310,5.3
1991,Sep,70.5,66.7,1801088,1704113,96975,5.4
1991,Oct,70.3,66.5,1803233,1704480,98753,5.5
1991,Nov,70.3,66.3,1805848,1705244,100604,5.6
1991,Dec,70.2,66.2,1809074,1706642,102432,5.7
1992,Jan,70.2,66.2,1813198,1708966,104232,5.7
1992,Feb,70.2,66.1,1818204,1712185,106019,5.8
1992,Mar,70.3,66.2,1824185,1716425,107760,5.9
1992,Apr,70.4,66.2,1830759,1721352,109407,6
1992,May,70.5,66.2,1837040,1726257,110783,6
1992,Jun,70.5,66.2,1842573,1730915,111658,6.1
1992,Jul,70.5,66.2,1847602,1735518,112084,6.1
1992,Aug,70.5,66.2,1852686,1740392,112294,6.1
1992,Sep,70.5,66.2,1858395,1745804,112591,6.1
1992,Oct,70.5,66.2,1865239,1752186,113053,6.1
1992,Nov,70.6,66.3,1872826,1759315,113511,6.1
1992,Dec,70.6,66.4,1880650,1766960,113690,6
1993,Jan,70.7,66.5,1888369,1775151,113218,6
1993,Feb,70.8,66.6,1895747,1783830,111917,5.9
1993,Mar,70.9,66.8,1903052,1793201,109851,5.8
1993,Apr,70.9,67,1910662,1803407,107255,5.6
1993,May,71,67.2,1918590,1814002,104588,5.5
1993,Jun,71.1,67.3,1926712,1824451,102261,5.3
1993,Jul,71.2,67.5,1934823,1834513,100310,5.2
1993,Aug,71.3,67.7,1942756,1844166,98590,5.1
1993,Sep,71.4,67.8,1950782,1853684,97098,5
1993,Oct,71.4,68,1959085,1863171,95914,4.9
1993,Nov,71.6,68.1,1967832,1872609,95223,4.8
1993,Dec,71.7,68.3,1977212,1882263,94949,4.8
1994,Jan,71.9,68.4,1986872,1892138,94734,4.8
1994,Feb,72,68.6,1996135,1901929,94206,4.7
1994,Mar,72.1,68.8,2004611,1911414,93197,4.6
1994,Apr,72.2,68.9,2012651,1920993,91658,4.6
1994,May,72.3,69.1,2021248,1931617,89631,4.4
1994,Jun,72.5,69.4,2031107,1943763,87344,4.3
1994,Jul,72.7,69.6,2042303,1957208,85095,4.2
1994,Aug,72.9,70,2054339,1971234,83105,4
1994,Sep,73.2,70.3,2066291,1984891,81400,3.9
1994,Oct,73.3,70.5,2077183,1997342,79841,3.8
1994,Nov,73.5,70.7,2086652,2008132,78520,3.8
1994,Dec,73.6,70.8,2094281,2016502,77779,3.7
1995,Jan,73.6,70.9,2099899,2022022,77877,3.7
1995,Feb,73.6,70.8,2104241,2025415,78826,3.7
1995,Mar,73.5,70.7,2108101,2027665,80436,3.8
1995,Apr,73.5,70.6,2112014,2029599,82415,3.9
1995,May,73.5,70.5,2116444,2032023,84421,4
1995,Jun,73.5,70.5,2121617,2035485,86132,4.1
1995,Jul,73.5,70.5,2127527,2040160,87367,4.1
1995,Aug,73.5,70.5,2133672,2045503,88169,4.1
1995,Sep,73.6,70.5,2139306,2050601,88705,4.1
1995,Oct,73.5,70.5,2143813,2054614,89199,4.2
1995,Nov,73.5,70.4,2146808,2057165,89643,4.2
1995,Dec,73.4,70.3,2148577,2058539,90038,4.2
1996,Jan,73.3,70.2,2150136,2059492,90644,4.2
1996,Feb,73.2,70.1,2151994,2060381,91613,4.3
1996,Mar,73.1,70,2153925,2061146,92779,4.3
1996,Apr,73,69.8,2155459,2061625,93834,4.4
1996,May,72.9,69.7,2156234,2061758,94476,4.4
1996,Jun,72.7,69.5,2156090,2061578,94512,4.4
1996,Jul,72.5,69.4,2155205,2061365,93840,4.4
1996,Aug,72.3,69.2,2154341,2061822,92519,4.3
1996,Sep,72.1,69.1,2154155,2063467,90688,4.2
1996,Oct,72,69,2155280,2066611,88669,4.1
1996,Nov,72,69.1,2158188,2071489,86699,4
1996,Dec,72,69.2,2162858,2078077,84781,3.9
1997,Jan,72,69.3,2168876,2086088,82788,3.8
1997,Feb,72.1,69.5,2175964,2095308,80656,3.7
1997,Mar,72.3,69.7,2184274,2105744,78530,3.6
1997,Apr,72.4,69.9,2193734,2117069,76665,3.5
1997,May,72.6,70.2,2203618,2128448,75170,3.4
1997,Jun,72.8,70.4,2213431,2139347,74084,3.3
1997,Jul,73,70.6,2223076,2149562,73514,3.3
1997,Aug,73.1,70.7,2232379,2158855,73524,3.3
1997,Sep,73.3,70.9,2241375,2167279,74096,3.3
1997,Oct,73.4,71,2250178,2174943,75235,3.3
1997,Nov,73.6,71.1,2258788,2181944,76844,3.4
1997,Dec,73.7,71.2,2267531,2188727,78804,3.5
1998,Jan,73.9,71.3,2276334,2195479,80855,3.6
1998,Feb,74.1,71.4,2284933,2202173,82760,3.6
1998,Mar,74.2,71.5,2292832,2208549,84283,3.7
1998,Apr,74.3,71.5,2299943,2214643,85300,3.7
1998,May,74.4,71.6,2306599,2220655,85944,3.7
1998,Jun,74.4,71.7,2312795,2226493,86302,3.7
1998,Jul,74.5,71.7,2318246,2231971,86275,3.7
1998,Aug,74.5,71.7,2323028,2237294,85734,3.7
1998,Sep,74.4,71.7,2327226,2242633,84593,3.6
1998,Oct,74.4,71.7,2330751,2248034,82717,3.5
1998,Nov,74.3,71.7,2333507,2253252,80255,3.4
1998,Dec,74.2,71.7,2335601,2258017,77584,3.3
1999,Jan,74.1,71.7,2337419,2262255,75164,3.2
1999,Feb,74,71.7,2339261,2265817,73444,3.1
1999,Mar,73.9,71.6,2341129,2268568,72561,3.1
1999,Apr,73.8,71.5,2342760,2270396,72364,3.1
1999,May,73.7,71.4,2343805,2271258,72547,3.1
1999,Jun,73.5,71.2,2344372,2271580,72792,3.1
1999,Jul,73.4,71.1,2344704,2271816,72888,3.1
1999,Aug,73.2,71,2344996,2272380,72616,3.1
1999,Sep,73.1,70.9,2345577,2273693,71884,3.1
1999,Oct,73,70.8,2346824,2276027,70797,3
1999,Nov,72.9,70.8,2349080,2279617,69463,3
1999,Dec,72.9,70.8,2351915,2283883,68032,2.9
2000,Jan,72.8,70.8,2354671,2287986,66685,2.8
2000,Feb,72.8,70.8,2356780,2291250,65530,2.8
2000,Mar,72.7,70.7,2357991,2293200,64791,2.7
2000,Apr,72.7,70.7,2358321,2293730,64591,2.7
2000,May,72.5,70.5,2357978,2293201,64777,2.7
2000,Jun,72.3,70.3,2357302,2292153,65149,2.8
2000,Jul,72.2,70.2,2356861,2291396,65465,2.8
2000,Aug,72,70,2357452,2291922,65530,2.8
2000,Sep,71.9,69.9,2359410,2294060,65350,2.8
2000,Oct,71.8,69.9,2362477,2297454,65023,2.8
2000,Nov,71.8,69.8,2365870,2301056,64814,2.7
2000,Dec,71.7,69.8,2368896,2303807,65089,2.7
2001,Jan,71.6,69.7,2371069,2304962,66107,2.8
2001,Feb,71.5,69.5,2372464,2304480,67984,2.9
2001,Mar,71.4,69.3,2373609,2302879,70730,3
2001,Apr,71.3,69.1,2375054,2300762,74292,3.1
2001,May,71.2,68.9,2377689,2299027,78662,3.3
2001,Jun,71.2,68.7,2382031,2298113,83918,3.5
2001,Jul,71.3,68.6,2388265,2298151,90114,3.8
2001,Aug,71.4,68.5,2395575,2298315,97260,4.1
2001,Sep,71.5,68.4,2403007,2298010,104997,4.4
2001,Oct,71.6,68.2,2410087,2297403,112684,4.7
2001,Nov,71.7,68.1,2416394,2296659,119735,5
2001,Dec,71.7,68,2421809,2296270,125539,5.2
2002,Jan,71.8,67.9,2426393,2296628,129765,5.3
2002,Feb,71.8,67.9,2430101,2297663,132438,5.4
2002,Mar,71.8,67.8,2433076,2299278,133798,5.5
2002,Apr,71.8,67.8,2436172,2301814,134358,5.5
2002,May,71.8,67.8,2439827,2305162,134665,5.5
2002,Jun,71.8,67.8,2443731,2308771,134960,5.5
2002,Jul,71.8,67.8,2447093,2311774,135319,5.5
2002,Aug,71.8,67.8,2449681,2313877,135804,5.5
2002,Sep,71.7,67.7,2451709,2315156,136553,5.6
2002,Oct,71.7,67.7,2453200,2315498,137702,5.6
2002,Nov,71.7,67.6,2454837,2315602,139235,5.7
2002,Dec,71.6,67.5,2457271,2316185,141086,5.7
2003,Jan,71.7,67.5,2461045,2317839,143206,5.8
2003,Feb,71.8,67.5,2466367,2320944,145423,5.9
2003,Mar,71.9,67.6,2472593,2325090,147503,6
2003,Apr,72,67.7,2478382,2329254,149128,6
2003,May,72,67.7,2482778,2332650,150128,6
2003,Jun,72.1,67.7,2486126,2335569,150557,6.1
2003,Jul,72.1,67.7,2488974,2338527,150447,6
2003,Aug,72.1,67.7,2491681,2341808,149873,6
2003,Sep,72.1,67.8,2494740,2345751,148989,6
2003,Oct,72.1,67.8,2498563,2350510,148053,5.9
2003,Nov,72.2,67.9,2503021,2355855,147166,5.9
2003,Dec,72.3,68,2507691,2361417,146274,5.8
2004,Jan,72.3,68.2,2512112,2366858,145254,5.8
2004,Feb,72.4,68.3,2516021,2372053,143968,5.7
2004,Mar,72.5,68.4,2519769,2377329,142440,5.7
2004,Apr,72.5,68.5,2523730,2382989,140741,5.6
2004,May,72.6,68.6,2527941,2388897,139044,5.5
2004,Jun,72.6,68.7,2532150,2394597,137553,5.4
2004,Jul,72.7,68.8,2536181,2399614,136567,5.4
2004,Aug,72.7,68.8,2539637,2403594,136043,5.4
2004,Sep,72.6,68.7,2542010,2406277,135733,5.3
2004,Oct,72.6,68.7,2543364,2407869,135495,5.3
2004,Nov,72.5,68.6,2544144,2408870,135274,5.3
2004,Dec,72.4,68.6,2545095,2409978,135117,5.3
2005,Jan,72.4,68.5,2546701,2411798,134903,5.3
2005,Feb,72.3,68.5,2548979,2414478,134501,5.3
2005,Mar,72.3,68.5,2551744,2417976,133768,5.2
2005,Apr,72.3,68.6,2554710,2422041,132669,5.2
2005,May,72.3,68.6,2557733,2426554,131179,5.1
2005,Jun,72.3,68.6,2560668,2431252,129416,5.1
2005,Jul,72.3,68.7,2563627,2435902,127725,5
2005,Aug,72.2,68.7,2567051,2440650,126401,4.9
2005,Sep,72.2,68.7,2571162,2445724,125438,4.9
2005,Oct,72.1,68.7,2575937,2451484,124453,4.8
2005,Nov,72.2,68.7,2581320,2458096,123224,4.8
2005,Dec,72.2,68.8,2587078,2465346,121732,4.7
2006,Jan,72.2,68.9,2593076,2472957,120119,4.6
2006,Feb,72.3,69,2599087,2480468,118619,4.6
2006,Mar,72.3,69.1,2604902,2487438,117464,4.5
2006,Apr,72.4,69.1,2610429,2493685,116744,4.5
2006,May,72.4,69.2,2615748,2499528,116220,4.4
2006,Jun,72.4,69.2,2620825,2505297,115528,4.4
2006,Jul,72.5,69.3,2625866,2511637,114229,4.4
2006,Aug,72.5,69.4,2630950,2518726,112224,4.3
2006,Sep,72.5,69.5,2635851,2526060,109791,4.2
2006,Oct,72.5,69.5,2640166,2533031,107135,4.1
2006,Nov,72.4,69.6,2643315,2538964,104351,3.9
2006,Dec,72.4,69.6,2644879,2543357,101522,3.8
2007,Jan,72.3,69.6,2645116,2546275,98841,3.7
2007,Feb,72.2,69.5,2645082,2548528,96554,3.7
2007,Mar,72.1,69.5,2645641,2550808,94833,3.6
2007,Apr,72,69.4,2647709,2553782,93927,3.5
2007,May,72,69.4,2651742,2557678,94064,3.5
2007,Jun,72,69.5,2657543,2562323,95220,3.6
2007,Jul,72.1,69.5,2664412,2567243,97169,3.6
2007,Aug,72.2,69.5,2671733,2572065,99668,3.7
2007,Sep,72.2,69.5,2679172,2576843,102329,3.8
2007,Oct,72.3,69.5,2686197,2581271,104926,3.9
2007,Nov,72.4,69.5,2692523,2585206,107317,4
2007,Dec,72.4,69.4,2698033,2588610,109423,4.1
2008,Jan,72.4,69.4,2702411,2591051,111360,4.1
2008,Feb,72.4,69.3,2705791,2592399,113392,4.2
2008,Mar,72.3,69.2,2708612,2592763,115849,4.3
2008,Apr,72.3,69.1,2711000,2592090,118910,4.4
2008,May,72.2,68.9,2713277,2590545,122732,4.5
2008,Jun,72.2,68.8,2715900,2588616,127284,4.7
2008,Jul,72.1,68.6,2718730,2586542,132188,4.9
2008,Aug,72.1,68.4,2721408,2584334,137074,5
2008,Sep,72,68.2,2723635,2581662,141973,5.2
2008,Oct,71.9,68,2725327,2578144,147183,5.4
2008,Nov,71.8,67.8,2726382,2573392,152990,5.6
2008,Dec,71.7,67.5,2727035,2567495,159540,5.9
2009,Jan,71.6,67.3,2727691,2560849,166842,6.1
2009,Feb,71.6,67,2728695,2553972,174723,6.4
2009,Mar,71.5,66.7,2730335,2547655,182680,6.7
2009,Apr,71.4,66.5,2732255,2542201,190054,7
2009,May,71.4,66.2,2733120,2536831,196289,7.2
2009,Jun,71.2,66,2732012,2530915,201097,7.4
2009,Jul,71,65.7,2728583,2523955,204628,7.5
2009,Aug,70.8,65.4,2723178,2515806,207372,7.6
2009,Sep,70.5,65.1,2717092,2507242,209850,7.7
2009,Oct,70.3,64.8,2711943,2499218,212725,7.8
2009,Nov,70.1,64.5,2709549,2492994,216555,8
2009,Dec,70.1,64.4,2710561,2489336,221225,8.2
2010,Jan,70.1,64.3,2714266,2488218,226048,8.3
2010,Feb,70.1,64.2,2718865,2488580,230285,8.5
2010,Mar,70.2,64.1,2722791,2489213,233578,8.6
2010,Apr,70.8,64.7,2725446,2489593,235853,8.7
2010,May,70.8,64.6,2726694,2489552,237142,8.7
2010,Jun,70.7,64.5,2726542,2488575,237967,8.7
2010,Jul,70.6,64.4,2725775,2486711,239064,8.8
2010,Aug,70.5,64.3,2725309,2484727,240582,8.8
2010,Sep,70.4,64.1,2725176,2483000,242176,8.9
2010,Oct,70.3,64,2725408,2482187,243221,8.9
2010,Nov,70.2,63.9,2725575,2482569,243006,8.9
2010,Dec,70.1,63.9,2725739,2484035,241704,8.9
2011,Jan,70,63.8,2726142,2486606,239536,8.8
2011,Feb,69.9,63.8,2726295,2489803,236492,8.7
2011,Mar,69.8,63.8,2725870,2492959,232911,8.5
2011,Apr,69.7,63.8,2725243,2495652,229591,8.4
2011,May,69.6,63.8,2725485,2498260,227225,8.3
2011,Jun,69.6,63.8,2727538,2501595,225943,8.3
2011,Jul,69.6,63.8,2731838,2506281,225557,8.3
2011,Aug,69.6,63.9,2737851,2512064,225787,8.2
2011,Sep,69.7,63.9,2744437,2518200,226237,8.2
2011,Oct,69.7,64,2750277,2523717,226560,8.2
2011,Nov,69.7,64,2754113,2527589,226524,8.2
2011,Dec,69.6,63.9,2755211,2529433,225778,8.2
2012,Jan,69.5,63.8,2754132,2529588,224544,8.2
2012,Feb,69.4,63.7,2752543,2529062,223481,8.1
2012,Mar,69.3,63.7,2751340,2528560,222780,8.1
2012,Apr,69.2,63.6,2750712,2528512,222200,8.1
2012,May,69.1,63.5,2751221,2529773,221448,8
2012,Jun,69,63.5,2753000,2532746,220254,8
2012,Jul,69,63.5,2755737,2537362,218375,7.9
2012,Aug,69,63.6,2759167,2543095,216072,7.8
2012,Sep,68.9,63.6,2763026,2549191,213835,7.7
2012,Oct,68.9,63.6,2766298,2554638,211660,7.7
2012,Nov,68.9,63.6,2768164,2558745,209419,7.6
2012,Dec,68.8,63.6,2768370,2561350,207020,7.5
2013,Jan,68.6,63.6,2767274,2562697,204577,7.4
2013,Feb,68.5,63.5,2765868,2563642,202226,7.3
2013,Mar,68.4,63.5,2765227,2565296,199931,7.2
2013,Apr,68.3,63.5,2766087,2568489,197598,7.1
2013,May,68.3,63.5,2767770,2572419,195351,7.1
2013,Jun,68.2,63.5,2769223,2576118,193105,7
2013,Jul,68.1,63.4,2769763,2579207,190556,6.9
2013,Aug,68,63.4,2769026,2581863,187163,6.8
2013,Sep,67.8,63.4,2767659,2584827,182832,6.6
2013,Oct,67.7,63.4,2767060,2588943,178117,6.4
2013,Nov,67.7,63.4,2768743,2595010,173733,6.3
2013,Dec,67.7,63.5,2772991,2603132,169859,6.1
2014,Jan,67.8,63.7,2781177,2615291,165886,6
2014,Feb,67.8,63.9,2787334,2625732,161602,5.8
2014,Mar,67.9,64,2792856,2636069,156787,5.6
2014,Apr,67.9,64.2,2796938,2645435,151503,5.4
2014,May,67.8,64.3,2799663,2653932,145731,5.2
2014,Jun,67.8,64.4,2801950,2662096,139854,5
2014,Jul,67.7,64.5,2804294,2669823,134471,4.8
2014,Aug,67.6,64.5,2807159,2677061,130098,4.6
2014,Sep,67.6,64.5,2810417,2683613,126804,4.5
2014,Oct,67.5,64.5,2813456,2689100,124356,4.4
2014,Nov,67.4,64.5,2815523,2693174,122349,4.3
2014,Dec,67.4,64.5,2816915,2696168,120747,4.3
2015,Jan,67.2,64.3,2815134,2694755,120379,4.3
2015,Feb,67.1,64.3,2816684,2697100,119584,4.2
2015,Mar,67,64.2,2818498,2699990,118508,4.2
2015,Apr,67,64.2,2820390,2703597,116793,4.1
2015,May,66.9,64.2,2821938,2707500,114438,4.1
2015,Jun,66.8,64.1,2822707,2711141,111566,4
2015,Jul,66.7,64.1,2823123,2714574,108549,3.8
2015,Aug,66.6,64.1,2824036,2718319,105717,3.7
2015,Sep,66.5,64.1,2826310,2723153,103157,3.6
2015,Oct,66.5,64.1,2830882,2729813,101069,3.6
2015,Nov,66.5,64.2,2837974,2738262,99712,3.5
2015,Dec,66.6,64.3,2846562,2747516,99046,3.5
2016,Jan,66.7,64.4,2855252,2756418,98834,3.5
2016,Feb,66.8,64.5,2863147,2764171,98976,3.5
2016,Mar,66.8,64.5,2869786,2770611,99175,3.5
2016,Apr,66.8,64.5,2875505,2776260,99245,3.5
2016,May,66.9,64.6,2881161,2782143,99018,3.4
2016,Jun,66.9,64.6,2887327,2789101,98226,3.4
2016,Jul,66.9,64.7,2894043,2797416,96627,3.3
2016,Aug,67,64.8,2901038,2806630,94408,3.3
2016,Sep,67.1,64.9,2908063,2816018,92045,3.2
2016,Oct,67.1,65,2914759,2825162,89597,3.1
2016,Nov,67.2,65.2,2921204,2834285,86919,3
2016,Dec,67.2,65.3,2927937,2843705,84232,2.9
2017,Jan,67.3,65.4,2935360,2853461,81899,2.8
2017,Feb,67.4,65.6,2943654,2863479,80175,2.7
2017,Mar,67.5,65.7,2952715,2873408,79307,2.7
2017,Apr,67.7,65.9,2962529,2883199,79330,2.7
2017,May,67.8,66,2972877,2892795,80082,2.7
2017,Jun,68,66.1,2983375,2901893,81482,2.7
2017,Jul,68.1,66.2,2993700,2910350,83350,2.8
2017,Aug,68.2,66.3,3003207,2918071,85136,2.8
2017,Sep,68.3,66.3,3011552,2925074,86478,2.9
2017,Oct,68.3,66.4,3018886,2931437,87449,2.9
2017,Nov,68.4,66.4,3025601,2937284,88317,2.9
2017,Dec,68.5,66.4,3032321,2943243,89078,2.9
2018,Jan,68.5,66.5,3039756,2949910,89846,3
2018,Feb,68.6,66.6,3048319,2957429,90890,3
2018,Mar,68.7,66.7,3057607,2965268,92339,3
2018,Apr,68.8,66.7,3066430,2972306,94124,3.1
2018,May,68.9,66.8,3073935,2977908,96027,3.1
2018,Jun,68.9,66.8,3080217,2982461,97756,3.2
2018,Jul,69,66.7,3085673,2986530,99143,3.2
2018,Aug,69,66.7,3091101,2990761,100340,3.2
2018,Sep,69,66.8,3096967,2995718,101249,3.3
2018,Oct,69,66.8,3103165,3001544,101621,3.3
2018,Nov,69.1,66.8,3109154,3007826,101328,3.3
2018,Dec,69.1,66.9,3114211,3013869,100342,3.2
2019,Jan,69.1,66.9,3118005,3019332,98673,3.2
2019,Feb,69.1,66.9,3120717,3024409,96308,3.1
2019,Mar,69.1,67,3123383,3029822,93561,3
2019,Apr,69,67,3127272,3036474,90798,2.9
2019,May,69.1,67.1,3133013,3044663,88350,2.8
2019,Jun,69.2,67.3,3140510,3054147,86363,2.7
2019,Jul,69.3,67.4,3150271,3065701,84570,2.7
2019,Aug,69.4,67.6,3160179,3077345,82834,2.6
2019,Sep,69.5,67.7,3168978,3087657,81321,2.6
2019,Oct,69.5,67.8,3175067,3094826,80241,2.5
2019,Nov,69.4,67.7,3175472,3095329,80143,2.5
2019,Dec,69.3,67.6,3174504,3094165,80339,2.5
2020,Jan,69.4,67.6,3180821,3101414,79407,2.5
2020,Feb,69.4,67.7,3186341,3106077,80264,2.5
2020,Mar,68.2,64.7,3136533,2972506,164027,5.2
2020,Apr,66.4,58.3,3054771,2681128,373643,12.2
2020,May,66.6,59.8,3069113,2755457,313656,10.2
2020,Jun,68.8,61.5,3177090,2840256,336834,10.6
2020,Jul,66.7,61.8,3084472,2854900,229572,7.4
2020,Aug,66.7,62.3,3087775,2882001,205774,6.7
2020,Sep,67.9,63.6,3147378,2945381,201997,6.4
