Year,Period,labor force participation rate,employment-population ratio,labor force,employment,unemployment,unemployment rate
1976,Jan,70.1,63,408869,367414,41455,10.1
1976,Feb,69.9,62.8,408905,367268,41637,10.2
1976,Mar,69.8,62.7,409265,367467,41798,10.2
1976,Apr,69.7,62.7,409939,368550,41389,10.1
1976,May,69.6,62.7,410495,369908,40587,9.9
1976,Jun,69.5,62.8,410779,371272,39507,9.6
1976,Jul,69.2,62.8,410576,372349,38227,9.3
1976,Aug,69.1,62.8,410176,373163,37013,9
1976,Sep,68.8,62.7,410045,373983,36062,8.8
1976,Oct,68.7,62.8,410397,374963,35434,8.6
1976,Nov,68.6,62.8,411212,376165,35047,8.5
1976,Dec,68.7,62.9,412337,377575,34762,8.4
1977,Jan,68.8,63.1,413616,379133,34483,8.3
1977,Feb,68.8,63.1,414902,380730,34172,8.2
1977,Mar,68.9,63.3,415929,382233,33696,8.1
1977,Apr,68.7,63.3,416462,383521,32941,7.9
1977,May,68.6,63.3,416569,384494,32075,7.7
1977,Jun,68.4,63.2,416515,385092,31423,7.5
1977,Jul,68.3,63.2,416627,385371,31256,7.5
1977,Aug,68.2,63.1,417000,385449,31551,7.6
1977,Sep,68.2,63,417476,385445,32031,7.7
1977,Oct,68.2,62.9,417914,385453,32461,7.8
1977,Nov,68,62.7,418156,385517,32639,7.8
1977,Dec,67.9,62.6,418076,385623,32453,7.8
1978,Jan,67.7,62.5,417633,385743,31890,7.6
1978,Feb,67.5,62.4,417004,385889,31115,7.5
1978,Mar,67.3,62.4,416525,386105,30420,7.3
1978,Apr,67.2,62.3,416500,386454,30046,7.2
1978,May,67,62.2,416994,386991,30003,7.2
1978,Jun,67.1,62.2,417847,387773,30074,7.2
1978,Jul,67.1,62.3,418807,388786,30021,7.2
1978,Aug,67,62.3,419622,389881,29741,7.1
1978,Sep,66.9,62.2,420187,390910,29277,7
1978,Oct,66.8,62.3,420445,391788,28657,6.8
1978,Nov,66.6,62.2,420473,392467,28006,6.7
1978,Dec,66.4,62.1,420461,392958,27503,6.5
1979,Jan,66.2,61.9,420610,393360,27250,6.5
1979,Feb,66.2,61.9,421047,393824,27223,6.5
1979,Mar,66.1,61.8,421835,394525,27310,6.5
1979,Apr,66.1,61.8,422942,395624,27318,6.5
1979,May,66.1,61.9,424172,397139,27033,6.4
1979,Jun,66.2,62,425369,398840,26529,6.2
1979,Jul,66.1,62.1,426417,400446,25971,6.1
1979,Aug,66,62.1,427284,401891,25393,5.9
1979,Sep,66,62.1,428055,403249,24806,5.8
1979,Oct,66,62.3,428876,404637,24239,5.7
1979,Nov,65.9,62.3,429918,406240,23678,5.5
1979,Dec,65.9,62.4,431236,408161,23075,5.4
1980,Jan,66,62.5,432730,410280,22450,5.2
1980,Feb,66.1,62.8,434206,412358,21848,5
1980,Mar,66.1,62.8,435491,414130,21361,4.9
1980,Apr,66,62.8,436513,415358,21155,4.8
1980,May,66.1,62.8,437355,416025,21330,4.9
1980,Jun,66.1,62.8,438138,416431,21707,5
1980,Jul,66.1,62.8,438980,416906,22074,5
1980,Aug,66.2,62.8,440007,417587,22420,5.1
1980,Sep,66.2,62.8,441210,418478,22732,5.2
1980,Oct,66.3,62.9,442501,419530,22971,5.2
1980,Nov,66.4,63,443761,420645,23116,5.2
1980,Dec,66.5,63,444955,421749,23206,5.2
1981,Jan,66.6,63.1,446093,422804,23289,5.2
1981,Feb,66.6,63.2,447165,423755,23410,5.2
1981,Mar,66.7,63.2,448121,424554,23567,5.3
1981,Apr,66.7,63.2,448913,425227,23686,5.3
1981,May,66.7,63.2,449564,425805,23759,5.3
1981,Jun,66.7,63.2,450165,426279,23886,5.3
1981,Jul,66.7,63.1,450753,426652,24101,5.3
1981,Aug,66.7,63.1,451320,426925,24395,5.4
1981,Sep,66.6,63,451860,427062,24798,5.5
1981,Oct,66.6,62.9,452382,427010,25372,5.6
1981,Nov,66.5,62.7,452833,426732,26101,5.8
1981,Dec,66.4,62.5,453182,426286,26896,5.9
1982,Jan,66.4,62.3,453501,425840,27661,6.1
1982,Feb,66.4,62.2,453913,425566,28347,6.2
1982,Mar,66.4,62.1,454504,425580,28924,6.4
1982,Apr,66.4,62.1,455326,425956,29370,6.5
1982,May,66.3,62,456360,426723,29637,6.5
1982,Jun,66.4,62.1,457503,427861,29642,6.5
1982,Jul,66.5,62.2,458736,429301,29435,6.4
1982,Aug,66.5,62.3,460100,430979,29121,6.3
1982,Sep,66.6,62.5,461613,432790,28823,6.2
1982,Oct,66.7,62.5,463267,434563,28704,6.2
1982,Nov,66.8,62.7,464976,436108,28868,6.2
1982,Dec,66.8,62.6,466542,437238,29304,6.3
1983,Jan,66.9,62.6,467731,437871,29860,6.4
1983,Feb,66.8,62.5,468499,438196,30303,6.5
1983,Mar,66.7,62.4,469048,438590,30458,6.5
1983,Apr,66.7,62.4,469639,439346,30293,6.5
1983,May,66.6,62.4,470431,440556,29875,6.4
1983,Jun,66.7,62.5,471446,442079,29367,6.2
1983,Jul,66.7,62.6,472579,443668,28911,6.1
1983,Aug,66.7,62.7,473539,445010,28529,6
1983,Sep,66.7,62.7,474061,445870,28191,5.9
1983,Oct,66.6,62.7,474046,446200,27846,5.9
1983,Nov,66.4,62.6,473654,446142,27512,5.8
1983,Dec,66.3,62.5,473238,446004,27234,5.8
1984,Jan,66.3,62.5,473143,446102,27041,5.7
1984,Feb,66.2,62.4,473417,446501,26916,5.7
1984,Mar,66.2,62.4,473803,447009,26794,5.7
1984,Apr,66.1,62.4,474005,447363,26642,5.6
1984,May,66,62.3,473860,447357,26503,5.6
1984,Jun,65.8,62.2,473384,446965,26419,5.6
1984,Jul,65.7,62,472718,446284,26434,5.6
1984,Aug,65.5,61.8,472144,445503,26641,5.6
1984,Sep,65.4,61.6,471965,444946,27019,5.7
1984,Oct,65.3,61.5,472238,444896,27342,5.8
1984,Nov,65.3,61.5,472856,445473,27383,5.8
1984,Dec,65.3,61.6,473609,446563,27046,5.7
1985,Jan,65.4,61.8,474287,447865,26422,5.6
1985,Feb,65.4,61.9,474852,449097,25755,5.4
1985,Mar,65.4,61.9,475393,450103,25290,5.3
1985,Apr,65.4,61.9,476029,450883,25146,5.3
1985,May,65.4,61.9,476867,451557,25310,5.3
1985,Jun,65.5,62,477921,452244,25677,5.4
1985,Jul,65.5,62,479132,453078,26054,5.4
1985,Aug,65.6,62,480448,454199,26249,5.5
1985,Sep,65.7,62.2,481810,455581,26229,5.4
1985,Oct,65.8,62.3,483217,457111,26106,5.4
1985,Nov,65.9,62.3,484656,458652,26004,5.4
1985,Dec,65.9,62.4,486011,460061,25950,5.3
1986,Jan,66,62.5,487195,461290,25905,5.3
1986,Feb,66.1,62.6,488185,462386,25799,5.3
1986,Mar,66.1,62.6,488997,463409,25588,5.2
1986,Apr,66.1,62.7,489659,464417,25242,5.2
1986,May,66,62.6,490212,465458,24754,5
1986,Jun,66,62.7,490708,466585,24123,4.9
1986,Jul,65.9,62.8,491234,467834,23400,4.8
1986,Aug,65.8,62.8,491871,469228,22643,4.6
1986,Sep,65.9,62.9,492678,470798,21880,4.4
1986,Oct,65.8,63,493747,472571,21176,4.3
1986,Nov,65.9,63.2,495151,474575,20576,4.2
1986,Dec,66,63.3,497006,476855,20151,4.1
1987,Jan,66.2,63.6,499299,479342,19957,4
1987,Feb,66.4,63.7,501808,481866,19942,4
1987,Mar,66.6,64,504291,484266,20025,4
1987,Apr,66.7,64.1,506545,486432,20113,4
1987,May,66.9,64.3,508514,488382,20132,4
1987,Jun,67,64.3,510318,490263,20055,3.9
1987,Jul,67.1,64.5,512112,492241,19871,3.9
1987,Aug,67.3,64.7,513927,494369,19558,3.8
1987,Sep,67.4,64.9,515695,496555,19140,3.7
1987,Oct,67.5,65.1,517210,498538,18672,3.6
1987,Nov,67.5,65.1,518247,500043,18204,3.5
1987,Dec,67.4,65.1,518647,500880,17767,3.4
1988,Jan,67.3,65.1,518394,501049,17345,3.3
1988,Feb,67.2,65,517728,500780,16948,3.3
1988,Mar,67,64.8,517010,500398,16612,3.2
1988,Apr,66.8,64.7,516564,500212,16352,3.2
1988,May,66.7,64.6,516538,500363,16175,3.1
1988,Jun,66.6,64.5,516864,500768,16096,3.1
1988,Jul,66.6,64.5,517355,501229,16126,3.1
1988,Aug,66.6,64.5,517892,501614,16278,3.1
1988,Sep,66.5,64.4,518414,501939,16475,3.2
1988,Oct,66.5,64.4,518899,502346,16553,3.2
1988,Nov,66.5,64.4,519363,502976,16387,3.2
1988,Dec,66.5,64.4,519854,503918,15936,3.1
1989,Jan,66.5,64.5,520494,505245,15249,2.9
1989,Feb,66.4,64.6,521355,506892,14463,2.8
1989,Mar,66.5,64.7,522435,508744,13691,2.6
1989,Apr,66.5,64.9,523727,510655,13072,2.5
1989,May,66.6,65,525177,512481,12696,2.4
1989,Jun,66.8,65.2,526707,514165,12542,2.4
1989,Jul,66.9,65.3,528230,515689,12541,2.4
1989,Aug,67,65.4,529641,516989,12652,2.4
1989,Sep,66.9,65.3,530904,518038,12866,2.4
1989,Oct,67,65.4,532121,518943,13178,2.5
1989,Nov,67.1,65.4,533499,519925,13574,2.5
1989,Dec,67.2,65.5,535275,521242,14033,2.6
1990,Jan,67.5,65.7,537573,523060,14513,2.7
1990,Feb,67.6,65.7,540295,525377,14918,2.8
1990,Mar,67.7,65.8,543173,528019,15154,2.8
1990,Apr,67.9,66,545920,530714,15206,2.8
1990,May,67.9,66,548373,533262,15111,2.8
1990,Jun,68,66.1,550518,535557,14961,2.7
1990,Jul,68,66.2,552444,537643,14801,2.7
1990,Aug,68.2,66.4,554331,539716,14615,2.6
1990,Sep,68.3,66.6,556357,541952,14405,2.6
1990,Oct,68.5,66.8,558615,544361,14254,2.6
1990,Nov,68.6,66.9,561050,546804,14246,2.5
1990,Dec,68.8,67.1,563383,549016,14367,2.6
1991,Jan,69,67.2,565354,550763,14591,2.6
1991,Feb,69.1,67.3,566920,552023,14897,2.6
1991,Mar,69.1,67.3,568140,552924,15216,2.7
1991,Apr,69.2,67.3,569190,553676,15514,2.7
1991,May,69.2,67.3,570225,554450,15775,2.8
1991,Jun,69.1,67.2,571272,555291,15981,2.8
1991,Jul,69.2,67.2,572333,556129,16204,2.8
1991,Aug,69.2,67.2,573364,556842,16522,2.9
1991,Sep,69.2,67.2,574318,557333,16985,3
1991,Oct,69.2,67.1,575201,557592,17609,3.1
1991,Nov,69.2,67,576027,557699,18328,3.2
1991,Dec,69.2,66.9,576900,557752,19148,3.3
1992,Jan,69.3,66.9,577900,557793,20107,3.5
1992,Feb,69.3,66.8,579008,557825,21183,3.7
1992,Mar,69.4,66.7,580269,557893,22376,3.9
1992,Apr,69.4,66.6,581565,558055,23510,4
1992,May,69.5,66.6,582787,558318,24469,4.2
1992,Jun,69.5,66.5,584005,558660,25345,4.3
1992,Jul,69.6,66.5,585256,559066,26190,4.5
1992,Aug,69.7,66.5,586474,559472,27002,4.6
1992,Sep,69.7,66.5,587501,559776,27725,4.7
1992,Oct,69.7,66.4,588201,559933,28268,4.8
1992,Nov,69.7,66.3,588530,559939,28591,4.9
1992,Dec,69.6,66.2,588531,559913,28618,4.9
1993,Jan,69.6,66.2,588316,560017,28299,4.8
1993,Feb,69.4,66.2,587990,560298,27692,4.7
1993,Mar,69.3,66.1,587615,560681,26934,4.6
1993,Apr,69.2,66.1,587268,561047,26221,4.5
1993,May,69.1,66.1,586960,561307,25653,4.4
1993,Jun,69,66,586594,561402,25192,4.3
1993,Jul,68.9,66,586134,561240,24894,4.2
1993,Aug,68.8,65.8,585674,560795,24879,4.2
1993,Sep,68.6,65.7,585411,560144,25267,4.3
1993,Oct,68.5,65.5,585413,559336,26077,4.5
1993,Nov,68.6,65.4,585643,558409,27234,4.7
1993,Dec,68.5,65.2,585979,557381,28598,4.9
1994,Jan,68.5,65,586184,556270,29914,5.1
1994,Feb,68.4,64.8,586117,555128,30989,5.3
1994,Mar,68.4,64.7,585762,554011,31751,5.4
1994,Apr,68.2,64.5,585218,552984,32234,5.5
1994,May,68.1,64.4,584690,552120,32570,5.6
1994,Jun,68,64.2,584364,551513,32851,5.6
1994,Jul,67.9,64.1,584337,551269,33068,5.7
1994,Aug,67.9,64.1,584564,551398,33166,5.7
1994,Sep,67.9,64.1,584865,551797,33068,5.7
1994,Oct,67.9,64.1,585074,552335,32739,5.6
1994,Nov,67.8,64.1,585139,552878,32261,5.5
1994,Dec,67.8,64.1,585140,553303,31837,5.4
1995,Jan,67.7,64.1,585249,553561,31688,5.4
1995,Feb,67.8,64.1,585579,553665,31914,5.4
1995,Mar,67.7,64,586106,553615,32491,5.5
1995,Apr,67.8,63.9,586677,553359,33318,5.7
1995,May,67.8,63.8,587123,552872,34251,5.8
1995,Jun,67.8,63.7,587287,552189,35098,6
1995,Jul,67.7,63.5,587091,551425,35666,6.1
1995,Aug,67.5,63.4,586645,550742,35903,6.1
1995,Sep,67.5,63.3,586262,550338,35924,6.1
1995,Oct,67.4,63.2,586287,550383,35904,6.1
1995,Nov,67.4,63.2,586903,550912,35991,6.1
1995,Dec,67.5,63.3,588063,551836,36227,6.2
1996,Jan,67.6,63.4,589572,552979,36593,6.2
1996,Feb,67.7,63.5,591180,554172,37008,6.3
1996,Mar,67.8,63.5,592662,555318,37344,6.3
1996,Apr,67.9,63.6,593866,556372,37494,6.3
1996,May,68,63.7,594686,557303,37383,6.3
1996,Jun,67.9,63.7,595245,558100,37145,6.2
1996,Jul,67.9,63.7,595831,558806,37025,6.2
1996,Aug,67.9,63.7,596586,559516,37070,6.2
1996,Sep,67.9,63.7,597508,560271,37237,6.2
1996,Oct,68,63.7,598500,561037,37463,6.3
1996,Nov,68,63.7,599423,561768,37655,6.3
1996,Dec,68,63.7,600133,562396,37737,6.3
1997,Jan,67.9,63.7,600564,562848,37716,6.3
1997,Feb,67.9,63.7,600739,563099,37640,6.3
1997,Mar,67.9,63.6,600793,563215,37578,6.3
1997,Apr,67.8,63.5,600925,563314,37611,6.3
1997,May,67.7,63.5,601226,563470,37756,6.3
1997,Jun,67.7,63.4,601580,563703,37877,6.3
1997,Jul,67.7,63.4,601792,563952,37840,6.3
1997,Aug,67.6,63.4,601745,564099,37646,6.3
1997,Sep,67.5,63.3,601364,564075,37289,6.2
1997,Oct,67.4,63.3,600735,563871,36864,6.1
1997,Nov,67.2,63.1,600001,563560,36441,6.1
1997,Dec,67.1,63.1,599374,563297,36077,6
1998,Jan,67.1,63.1,599041,563177,35864,6
1998,Feb,67,63,599083,563230,35853,6
1998,Mar,67.1,63,599444,563436,36008,6
1998,Apr,67.1,63.1,600078,563778,36300,6
1998,May,67.1,63,600950,564254,36696,6.1
1998,Jun,67.2,63.1,601925,564818,37107,6.2
1998,Jul,67.2,63.1,602789,565391,37398,6.2
1998,Aug,67.3,63.1,603386,565899,37487,6.2
1998,Sep,67.3,63.1,603594,566242,37352,6.2
1998,Oct,67.3,63.1,603353,566365,36988,6.1
1998,Nov,67.1,63.1,602765,566276,36489,6.1
1998,Dec,67,63,602016,566068,35948,6
1999,Jan,66.9,63,601291,565918,35373,5.9
1999,Feb,66.9,63,600788,565973,34815,5.8
1999,Mar,66.8,63,600667,566335,34332,5.7
1999,Apr,66.9,63.1,600922,567014,33908,5.6
1999,May,66.9,63.2,601442,567958,33484,5.6
1999,Jun,67,63.3,602167,569117,33050,5.5
1999,Jul,67.1,63.4,602987,570430,32557,5.4
1999,Aug,67.1,63.5,603786,571823,31963,5.3
1999,Sep,67.1,63.7,604516,573226,31290,5.2
1999,Oct,67.1,63.7,605132,574567,30565,5.1
1999,Nov,67.2,63.9,605607,575804,29803,4.9
1999,Dec,67.1,63.9,605956,576900,29056,4.8
2000,Jan,67.1,64,606200,577849,28351,4.7
2000,Feb,67.1,64.1,606306,578645,27661,4.6
2000,Mar,67.1,64.1,606226,579217,27009,4.5
2000,Apr,67.5,64.5,605946,579490,26456,4.4
2000,May,67.4,64.5,605553,579520,26033,4.3
2000,Jun,67.4,64.5,605133,579451,25682,4.2
2000,Jul,67.3,64.5,604857,579512,25345,4.2
2000,Aug,67.3,64.5,604851,579867,24984,4.1
2000,Sep,67.2,64.5,605219,580592,24627,4.1
2000,Oct,67.3,64.6,605983,581669,24314,4
2000,Nov,67.3,64.7,607116,582944,24172,4
2000,Dec,67.4,64.7,608459,584172,24287,4
2001,Jan,67.5,64.8,609767,585116,24651,4
2001,Feb,67.6,64.8,610857,585663,25194,4.1
2001,Mar,67.6,64.8,611587,585857,25730,4.2
2001,Apr,67.6,64.7,611891,585919,25972,4.2
2001,May,67.5,64.7,611794,585884,25910,4.2
2001,Jun,67.4,64.6,611453,585572,25881,4.2
2001,Jul,67.3,64.5,611068,584822,26246,4.3
2001,Aug,67.3,64.3,610738,583582,27156,4.4
2001,Sep,67.2,64,610436,581940,28496,4.7
2001,Oct,67.1,63.8,610015,580075,29940,4.9
2001,Nov,66.9,63.5,609224,578199,31025,5.1
2001,Dec,66.7,63.3,607947,576568,31379,5.2
2002,Jan,66.5,63.1,606336,575430,30906,5.1
2002,Feb,66.3,63,604597,574859,29738,4.9
2002,Mar,66.1,63,602963,574713,28250,4.7
2002,Apr,65.9,62.9,601660,574734,26926,4.5
2002,May,65.7,62.9,600777,574816,25961,4.3
2002,Jun,65.6,62.9,600235,575022,25213,4.2
2002,Jul,65.5,62.9,599813,575288,24525,4.1
2002,Aug,65.5,62.9,599445,575600,23845,4
2002,Sep,65.4,62.9,599174,575964,23210,3.9
2002,Oct,65.3,62.9,599081,576387,22694,3.8
2002,Nov,65.3,62.9,599269,576882,22387,3.7
2002,Dec,65.3,62.9,599738,577390,22348,3.7
2003,Jan,65.3,62.9,600369,577752,22617,3.8
2003,Feb,65.4,62.9,601082,577895,23187,3.9
2003,Mar,65.5,62.9,601773,577856,23917,4
2003,Apr,65.5,62.8,602346,577678,24668,4.1
2003,May,65.5,62.8,602759,577434,25325,4.2
2003,Jun,65.5,62.7,603062,577261,25801,4.3
2003,Jul,65.5,62.7,603338,577300,26038,4.3
2003,Aug,65.4,62.6,603616,577613,26003,4.3
2003,Sep,65.3,62.5,603867,578192,25675,4.3
2003,Oct,65.2,62.5,604147,578984,25163,4.2
2003,Nov,65.1,62.4,604518,579947,24571,4.1
2003,Dec,65,62.4,605037,581071,23966,4
2004,Jan,64.9,62.4,605696,582339,23357,3.9
2004,Feb,64.9,62.5,606451,583735,22716,3.7
2004,Mar,64.9,62.5,607309,585242,22067,3.6
2004,Apr,64.8,62.5,608217,586795,21422,3.5
2004,May,64.8,62.6,609115,588293,20822,3.4
2004,Jun,64.8,62.6,610046,589692,20354,3.3
2004,Jul,64.7,62.6,611058,591012,20046,3.3
2004,Aug,64.8,62.7,612139,592265,19874,3.2
2004,Sep,64.9,62.8,613307,593495,19812,3.2
2004,Oct,65,62.9,614534,594765,19769,3.2
2004,Nov,65.1,63,615778,596123,19655,3.2
2004,Dec,65.2,63.1,617036,597590,19446,3.2
2005,Jan,65.2,63.2,618291,599159,19132,3.1
2005,Feb,65.3,63.4,619544,600800,18744,3
2005,Mar,65.4,63.5,620871,602533,18338,3
2005,Apr,65.6,63.7,622409,604430,17979,2.9
2005,May,65.7,63.9,624246,606511,17735,2.8
2005,Jun,65.9,64,626274,608636,17638,2.8
2005,Jul,66.1,64.2,628344,610661,17683,2.8
2005,Aug,66.2,64.4,630269,612494,17775,2.8
2005,Sep,66.3,64.5,631847,614058,17789,2.8
2005,Oct,66.3,64.5,632984,615308,17676,2.8
2005,Nov,66.3,64.5,633728,616227,17501,2.8
2005,Dec,66.3,64.5,634192,616834,17358,2.7
2006,Jan,66.3,64.5,634584,617244,17340,2.7
2006,Feb,66.3,64.5,635058,617569,17489,2.8
2006,Mar,66.3,64.5,635644,617908,17736,2.8
2006,Apr,66.3,64.5,636333,618399,17934,2.8
2006,May,66.4,64.5,637075,619140,17935,2.8
2006,Jun,66.4,64.6,637851,620193,17658,2.8
2006,Jul,66.5,64.7,638666,621567,17099,2.7
2006,Aug,66.5,64.8,639519,623117,16402,2.6
2006,Sep,66.6,64.9,640383,624606,15777,2.5
2006,Oct,66.6,65,641194,625805,15389,2.4
2006,Nov,66.6,65,641831,626523,15308,2.4
2006,Dec,66.6,65,642158,626660,15498,2.4
2007,Jan,66.5,64.9,642117,626279,15838,2.5
2007,Feb,66.5,64.8,641708,625507,16201,2.5
2007,Mar,66.3,64.6,640924,624413,16511,2.6
2007,Apr,66.2,64.4,639825,623060,16765,2.6
2007,May,66,64.3,638583,621590,16993,2.7
2007,Jun,65.8,64.1,637381,620144,17237,2.7
2007,Jul,65.7,63.9,636426,618828,17598,2.8
2007,Aug,65.6,63.7,635928,617812,18116,2.8
2007,Sep,65.6,63.6,635971,617250,18721,2.9
2007,Oct,65.6,63.6,636486,617207,19279,3
2007,Nov,65.6,63.6,637357,617646,19711,3.1
2007,Dec,65.7,63.6,638468,618405,20063,3.1
2008,Jan,65.8,63.7,639620,619170,20450,3.2
2008,Feb,65.9,63.7,640651,619650,21001,3.3
2008,Mar,65.9,63.7,641492,619682,21810,3.4
2008,Apr,65.9,63.6,642055,619130,22925,3.6
2008,May,65.9,63.4,642213,617884,24329,3.8
2008,Jun,65.8,63.2,641937,615993,25944,4
2008,Jul,65.7,62.9,641232,613570,27662,4.3
2008,Aug,65.6,62.6,640136,610705,29431,4.6
2008,Sep,65.4,62.2,638797,607480,31317,4.9
2008,Oct,65.2,61.8,637383,603962,33421,5.2
2008,Nov,65,61.4,636024,600271,35753,5.6
2008,Dec,64.9,61,634791,596591,38200,6
2009,Jan,64.7,60.6,633729,593141,40588,6.4
2009,Feb,64.6,60.3,632864,590177,42687,6.7
2009,Mar,64.5,60,632205,587893,44312,7
2009,Apr,64.4,59.8,631768,586360,45408,7.2
2009,May,64.4,59.7,631561,585526,46035,7.3
2009,Jun,64.4,59.6,631468,585167,46301,7.3
2009,Jul,64.3,59.6,631328,584990,46338,7.3
2009,Aug,64.2,59.5,631138,584861,46277,7.3
2009,Sep,64.2,59.5,630972,584806,46166,7.3
2009,Oct,64.1,59.5,630928,584936,45992,7.3
2009,Nov,64.1,59.5,631194,585445,45749,7.2
2009,Dec,64.2,59.6,631973,586547,45426,7.2
2010,Jan,64.3,59.7,633386,588348,45038,7.1
2010,Feb,64.5,59.9,635460,590772,44688,7
2010,Mar,64.7,60.2,638106,593618,44488,7
2010,Apr,61.7,57.4,641085,596613,44472,6.9
2010,May,61.9,57.6,644088,599477,44611,6.9
2010,Jun,62.1,57.8,646940,602056,44884,6.9
2010,Jul,62.2,57.9,649539,604352,45187,7
2010,Aug,62.3,58,651813,606417,45396,7
2010,Sep,62.5,58.1,653823,608354,45469,7
2010,Oct,62.6,58.3,655746,610345,45401,6.9
2010,Nov,62.7,58.4,657619,612429,45190,6.9
2010,Dec,62.8,58.5,659367,614455,44912,6.8
2011,Jan,62.9,58.6,660878,616210,44668,6.8
2011,Feb,63,58.7,661975,617480,44495,6.7
2011,Mar,62.9,58.7,662537,618118,44419,6.7
2011,Apr,62.9,58.7,662598,618126,44472,6.7
2011,May,62.8,58.6,662280,617623,44657,6.7
2011,Jun,62.7,58.5,661708,616779,44929,6.8
2011,Jul,62.6,58.3,661013,615789,45224,6.8
2011,Aug,62.5,58.2,660222,614761,45461,6.9
2011,Sep,62.3,58,659208,613689,45519,6.9
2011,Oct,62.1,57.8,657897,612521,45376,6.9
2011,Nov,61.9,57.7,656316,611242,45074,6.9
2011,Dec,61.7,57.5,654557,609940,44617,6.8
2012,Jan,61.5,57.4,652737,608722,44015,6.7
2012,Feb,61.3,57.2,650981,607650,43331,6.7
2012,Mar,61.1,57.1,649380,606805,42575,6.6
2012,Apr,60.9,57,648004,606292,41712,6.4
2012,May,60.8,57,646905,606172,40733,6.3
2012,Jun,60.7,56.9,646109,606476,39633,6.1
2012,Jul,60.6,57,645600,607153,38447,6
2012,Aug,60.5,57,645340,608092,37248,5.8
2012,Sep,60.5,57.1,645309,609187,36122,5.6
2012,Oct,60.4,57.2,645403,610281,35122,5.4
2012,Nov,60.4,57.2,645533,611255,34278,5.3
2012,Dec,60.4,57.2,645678,612064,33614,5.2
2013,Jan,60.3,57.2,645877,612783,33094,5.1
2013,Feb,60.3,57.3,646236,613585,32651,5.1
2013,Mar,60.4,57.3,646805,614550,32255,5
2013,Apr,60.4,57.4,647585,615685,31900,4.9
2013,May,60.4,57.5,648595,616980,31615,4.9
2013,Jun,60.5,57.6,649820,618374,31446,4.8
2013,Jul,60.6,57.7,651268,619844,31424,4.8
2013,Aug,60.7,57.8,652939,621437,31502,4.8
2013,Sep,60.9,57.9,654749,623139,31610,4.8
2013,Oct,61,58.1,656561,624895,31666,4.8
2013,Nov,61.2,58.2,658284,626679,31605,4.8
2013,Dec,61.3,58.4,659842,628445,31397,4.8
2014,Jan,61.3,58.4,660487,629478,31009,4.7
2014,Feb,61.4,58.6,661607,630998,30609,4.6
2014,Mar,61.5,58.7,662647,632399,30248,4.6
2014,Apr,61.5,58.8,663661,633712,29949,4.5
2014,May,61.6,58.9,664619,634978,29641,4.5
2014,Jun,61.7,59,665525,636257,29268,4.4
2014,Jul,61.7,59,666335,637494,28841,4.3
2014,Aug,61.7,59.1,667034,638632,28402,4.3
2014,Sep,61.8,59.2,667668,639674,27994,4.2
2014,Oct,61.8,59.2,668290,640647,27643,4.1
2014,Nov,61.8,59.3,668912,641566,27346,4.1
2014,Dec,61.8,59.3,669552,642477,27075,4
2015,Jan,61.9,59.4,670037,643262,26775,4
2015,Feb,61.9,59.4,670669,644276,26393,3.9
2015,Mar,61.9,59.5,671270,645400,25870,3.9
2015,Apr,62,59.6,671883,646611,25272,3.8
2015,May,62,59.7,672531,647848,24683,3.7
2015,Jun,62,59.8,673202,649060,24142,3.6
2015,Jul,62.1,59.9,673942,650288,23654,3.5
2015,Aug,62.1,59.9,674760,651571,23189,3.4
2015,Sep,62.1,60,675591,652891,22700,3.4
2015,Oct,62.2,60.1,676414,654236,22178,3.3
2015,Nov,62.2,60.2,677189,655529,21660,3.2
2015,Dec,62.2,60.3,677861,656656,21205,3.1
2016,Jan,62.2,60.3,678412,657553,20859,3.1
2016,Feb,62.2,60.3,678930,658255,20675,3
2016,Mar,62.3,60.4,679536,658903,20633,3
2016,Apr,62.3,60.4,680322,659690,20632,3
2016,May,62.4,60.5,681389,660776,20613,3
2016,Jun,62.5,60.6,682721,662181,20540,3
2016,Jul,62.6,60.7,684127,663757,20370,3
2016,Aug,62.7,60.8,685410,665279,20131,2.9
2016,Sep,62.7,60.9,686464,666585,19879,2.9
2016,Oct,62.8,61,687208,667580,19628,2.9
2016,Nov,62.8,61.1,687668,668305,19363,2.8
2016,Dec,62.8,61.1,687924,668843,19081,2.8
2017,Jan,62.9,61.1,688024,669251,18773,2.7
2017,Feb,62.9,61.2,687957,669537,18420,2.7
2017,Mar,62.9,61.2,687625,669607,18018,2.6
2017,Apr,62.8,61.2,686961,669390,17571,2.6
2017,May,62.7,61.1,685965,668886,17079,2.5
2017,Jun,62.6,61.1,684689,668120,16569,2.4
2017,Jul,62.5,61,683294,667191,16103,2.4
2017,Aug,62.4,60.9,681950,666235,15715,2.3
2017,Sep,62.2,60.8,680790,665358,15432,2.3
2017,Oct,62.2,60.8,679933,664648,15285,2.2
2017,Nov,62.1,60.7,679401,664138,15263,2.2
2017,Dec,62.1,60.7,679141,663827,15314,2.3
2018,Jan,62.1,60.7,679065,663660,15405,2.3
2018,Feb,62.1,60.7,679046,663511,15535,2.3
2018,Mar,62.1,60.7,678937,663231,15706,2.3
2018,Apr,62.1,60.6,678570,662636,15934,2.3
2018,May,62,60.5,677814,661581,16233,2.4
2018,Jun,61.9,60.4,676721,660105,16616,2.5
2018,Jul,61.8,60.2,675415,658357,17058,2.5
2018,Aug,61.7,60.1,674009,656498,17511,2.6
2018,Sep,61.5,59.9,672600,654679,17921,2.7
2018,Oct,61.4,59.8,671226,652992,18234,2.7
2018,Nov,61.3,59.6,669859,651429,18430,2.8
2018,Dec,61.2,59.5,668439,649931,18508,2.8
2019,Jan,61.1,59.4,666938,648451,18487,2.8
2019,Feb,60.9,59.2,665402,647012,18390,2.8
2019,Mar,60.8,59.1,664000,645727,18273,2.8
2019,Apr,60.7,59.1,662973,644777,18196,2.7
2019,May,60.7,59,662531,644353,18178,2.7
2019,Jun,60.7,59.1,662720,644530,18190,2.7
2019,Jul,60.8,59.1,663544,645387,18157,2.7
2019,Aug,60.9,59.3,664641,646583,18058,2.7
2019,Sep,61,59.4,665785,647883,17902,2.7
2019,Oct,61.1,59.5,666583,648848,17735,2.7
2019,Nov,61.1,59.5,666654,648988,17666,2.6
2019,Dec,61.1,59.5,666539,648873,17666,2.7
2020,Jan,61.3,59.6,668169,650377,17792,2.7
2020,Feb,61.4,59.7,669072,651215,17857,2.7
2020,Mar,61.1,59.6,665727,649770,15957,2.4
2020,Apr,58.2,44.3,633724,482814,150910,23.8
2020,May,57.5,44,626986,479621,147365,23.5
2020,Jun,57.9,50.2,630798,546317,84481,13.4
2020,Jul,58.6,50.7,638124,552045,86079,13.5
2020,Aug,58.7,51.1,639549,556727,82822,13
2020,Sep,56.3,47.8,612768,520224,92544,15.1
