Year,Period,labor force participation rate,employment-population ratio,labor force,employment,unemployment,unemployment rate
1976,Jan,63.8,59.7,2418961,2260951,158010,6.5
1976,Feb,63.7,59.6,2418034,2259666,158368,6.5
1976,Mar,63.7,59.5,2418009,2260937,157072,6.5
1976,Apr,63.7,59.7,2421035,2269249,151786,6.3
1976,May,63.7,59.9,2426290,2280665,145625,6
1976,Jun,63.9,60.2,2433743,2292942,140801,5.8
1976,Jul,64,60.4,2441098,2302543,138555,5.7
1976,Aug,64.1,60.4,2446534,2308102,138432,5.7
1976,Sep,64.1,60.4,2449803,2310374,139429,5.7
1976,Oct,64,60.3,2451113,2309792,141321,5.8
1976,Nov,63.9,60.2,2450735,2307827,142908,5.8
1976,Dec,63.8,60.1,2449848,2306491,143357,5.9
1977,Jan,63.8,60.1,2450849,2307840,143009,5.8
1977,Feb,63.8,60.1,2455042,2312544,142498,5.8
1977,Mar,63.9,60.2,2461636,2319534,142102,5.8
1977,Apr,64,60.4,2469608,2327568,142040,5.8
1977,May,64.2,60.5,2477586,2335266,142320,5.7
1977,Jun,64.3,60.6,2484971,2342099,142872,5.7
1977,Jul,64.4,60.7,2492340,2348443,143897,5.8
1977,Aug,64.5,60.8,2500562,2355133,145429,5.8
1977,Sep,64.7,60.9,2509449,2362916,146533,5.8
1977,Oct,64.8,61,2518128,2371529,146599,5.8
1977,Nov,64.9,61.2,2526710,2380288,146422,5.8
1977,Dec,65.1,61.3,2535021,2388471,146550,5.8
1978,Jan,65.2,61.4,2542724,2396136,146588,5.8
1978,Feb,65.3,61.5,2550283,2403936,146347,5.7
1978,Mar,65.4,61.7,2558808,2413013,145795,5.7
1978,Apr,65.6,61.9,2568670,2423748,144922,5.6
1978,May,65.8,62.1,2579613,2435707,143906,5.6
1978,Jun,66,62.3,2590550,2447637,142913,5.5
1978,Jul,66.1,62.5,2600238,2457912,142326,5.5
1978,Aug,66.2,62.6,2608117,2465669,142448,5.5
1978,Sep,66.3,62.7,2614264,2471068,143196,5.5
1978,Oct,66.4,62.8,2620055,2475615,144440,5.5
1978,Nov,66.5,62.8,2625841,2480148,145693,5.5
1978,Dec,66.5,62.8,2630718,2484023,146695,5.6
1979,Jan,66.6,62.8,2633644,2486271,147373,5.6
1979,Feb,66.5,62.8,2633951,2486179,147772,5.6
1979,Mar,66.4,62.6,2632070,2483431,148639,5.6
1979,Apr,66.2,62.4,2629445,2478349,151096,5.7
1979,May,66.1,62.2,2628052,2472176,155876,5.9
1979,Jun,66.1,62,2628732,2465934,162798,6.2
1979,Jul,66.1,61.8,2631761,2460879,170882,6.5
1979,Aug,66.2,61.7,2636719,2457281,179438,6.8
1979,Sep,66.3,61.6,2642135,2454316,187819,7.1
1979,Oct,66.3,61.4,2645764,2450837,194927,7.4
1979,Nov,66.3,61.3,2646575,2445896,200679,7.6
1979,Dec,66.2,61,2645461,2439157,206304,7.8
1980,Jan,66.1,60.7,2643812,2429913,213899,8.1
1980,Feb,66,60.4,2642605,2417618,224987,8.5
1980,Mar,65.9,60,2641722,2402389,239333,9.1
1980,Apr,65.9,59.5,2640200,2385471,254729,9.6
1980,May,65.7,59.1,2637104,2369036,268068,10.2
1980,Jun,65.6,58.7,2632410,2355675,276735,10.5
1980,Jul,65.4,58.5,2625980,2347010,278970,10.6
1980,Aug,65.2,58.4,2618303,2343744,274559,10.5
1980,Sep,65,58.4,2611600,2345679,265921,10.2
1980,Oct,64.9,58.5,2607816,2351170,256646,9.8
1980,Nov,64.8,58.6,2608148,2358634,249514,9.6
1980,Dec,64.9,58.8,2612683,2366839,245844,9.4
1981,Jan,65.1,59,2619525,2374106,245419,9.4
1981,Feb,65.2,59.1,2625896,2379142,246754,9.4
1981,Mar,65.3,59.1,2630001,2381811,248190,9.4
1981,Apr,65.3,59.1,2630587,2381850,248737,9.5
1981,May,65.1,59,2627438,2378844,248594,9.5
1981,Jun,65,58.8,2621806,2373349,248457,9.5
1981,Jul,64.8,58.6,2615743,2365824,249919,9.6
1981,Aug,64.7,58.4,2610970,2356634,254336,9.7
1981,Sep,64.6,58.1,2607870,2346305,261565,10
1981,Oct,64.5,57.8,2606383,2335431,270952,10.4
1981,Nov,64.5,57.5,2605506,2324126,281380,10.8
1981,Dec,64.4,57.2,2604457,2313359,291098,11.2
1982,Jan,64.4,57,2603253,2304930,298323,11.5
1982,Feb,64.3,56.9,2602154,2299445,302709,11.6
1982,Mar,64.3,56.8,2600687,2295951,304736,11.7
1982,Apr,64.2,56.7,2599029,2293752,305277,11.7
1982,May,64.2,56.6,2597511,2292323,305188,11.7
1982,Jun,64.1,56.6,2596473,2290597,305876,11.8
1982,Jul,64.1,56.5,2596540,2288204,308336,11.9
1982,Aug,64.2,56.4,2597794,2285328,312466,12
1982,Sep,64.2,56.3,2599810,2281968,317842,12.2
1982,Oct,64.2,56.3,2601369,2278257,323112,12.4
1982,Nov,64.2,56.1,2600766,2274443,326323,12.5
1982,Dec,64.1,56,2595787,2269807,325980,12.6
1983,Jan,63.8,55.9,2586314,2264195,322119,12.5
1983,Feb,63.5,55.8,2574814,2259483,315331,12.2
1983,Mar,63.3,55.7,2564967,2257782,307185,12
1983,Apr,63.2,55.8,2560487,2260626,299861,11.7
1983,May,63.2,56,2562821,2268296,294525,11.5
1983,Jun,63.4,56.2,2570934,2280036,290898,11.3
1983,Jul,63.7,56.6,2581882,2294177,287705,11.1
1983,Aug,63.9,56.9,2592368,2308231,284137,11
1983,Sep,64.1,57.2,2599759,2320651,279108,10.7
1983,Oct,64.1,57.4,2603147,2331035,272112,10.5
1983,Nov,64.1,57.6,2603826,2339828,263998,10.1
1983,Dec,64.1,57.8,2604679,2348636,256043,9.8
1984,Jan,64.1,58,2607658,2359294,248364,9.5
1984,Feb,64.2,58.3,2612839,2371959,240880,9.2
1984,Mar,64.3,58.6,2619220,2385472,233748,8.9
1984,Apr,64.4,58.9,2624805,2397868,226937,8.6
1984,May,64.5,59.1,2628588,2407432,221156,8.4
1984,Jun,64.5,59.2,2630311,2413364,216947,8.2
1984,Jul,64.5,59.2,2630850,2416129,214721,8.2
1984,Aug,64.5,59.3,2632155,2417495,214660,8.2
1984,Sep,64.6,59.3,2635829,2419195,216634,8.2
1984,Oct,64.7,59.4,2642991,2423168,219823,8.3
1984,Nov,65,59.5,2653662,2431079,222583,8.4
1984,Dec,65.3,59.8,2666638,2442769,223869,8.4
1985,Jan,65.6,60.1,2679887,2455980,223907,8.4
1985,Feb,65.9,60.4,2691544,2468168,223376,8.3
1985,Mar,66.1,60.6,2700260,2477912,222348,8.2
1985,Apr,66.2,60.8,2705884,2485057,220827,8.2
1985,May,66.3,60.9,2709275,2490499,218776,8.1
1985,Jun,66.3,61,2711724,2495528,216196,8
1985,Jul,66.3,61.1,2714094,2500978,213116,7.9
1985,Aug,66.4,61.3,2716499,2507761,208738,7.7
1985,Sep,66.4,61.4,2719130,2516182,202948,7.5
1985,Oct,66.4,61.6,2722189,2525257,196932,7.2
1985,Nov,66.5,61.8,2725510,2533319,192191,7.1
1985,Dec,66.5,61.9,2728807,2539064,189743,7
1986,Jan,66.6,61.9,2732320,2542470,189850,6.9
1986,Feb,66.6,61.9,2736355,2544685,191670,7
1986,Mar,66.7,62,2740634,2546898,193736,7.1
1986,Apr,66.7,62,2744818,2549939,194879,7.1
1986,May,66.8,62.1,2748303,2554060,194243,7.1
1986,Jun,66.8,62.1,2751063,2559147,191916,7
1986,Jul,66.8,62.3,2753281,2564731,188550,6.8
1986,Aug,66.8,62.3,2754982,2569524,185458,6.7
1986,Sep,66.8,62.3,2756033,2572241,183792,6.7
1986,Oct,66.7,62.3,2755968,2572543,183425,6.7
1986,Nov,66.6,62.2,2754784,2570884,183900,6.7
1986,Dec,66.6,62.1,2753727,2569234,184493,6.7
1987,Jan,66.5,62,2753688,2568971,184717,6.7
1987,Feb,66.5,62,2754579,2570195,184384,6.7
1987,Mar,66.5,62,2756325,2572700,183625,6.7
1987,Apr,66.4,62.1,2758217,2576026,182191,6.6
1987,May,66.4,62.1,2759439,2579510,179929,6.5
1987,Jun,66.4,62.1,2759516,2582590,176926,6.4
1987,Jul,66.3,62.1,2758595,2585409,173186,6.3
1987,Aug,66.2,62.2,2757462,2588639,168823,6.1
1987,Sep,66.2,62.2,2757103,2593328,163775,5.9
1987,Oct,66.2,62.4,2758270,2599612,158658,5.8
1987,Nov,66.2,62.5,2761088,2607094,153994,5.6
1987,Dec,66.2,62.6,2764624,2614458,150166,5.4
1988,Jan,66.3,62.7,2767973,2620899,147074,5.3
1988,Feb,66.3,62.8,2771375,2626638,144737,5.2
1988,Mar,66.4,62.9,2775225,2631760,143465,5.2
1988,Apr,66.4,63,2780128,2636730,143398,5.2
1988,May,66.5,63.1,2786784,2642423,144361,5.2
1988,Jun,66.7,63.2,2795543,2649546,145997,5.2
1988,Jul,66.9,63.4,2806139,2658163,147976,5.3
1988,Aug,67.2,63.6,2817870,2667865,150005,5.3
1988,Sep,67.4,63.8,2829632,2678062,151570,5.4
1988,Oct,67.6,64,2839623,2688270,151353,5.3
1988,Nov,67.8,64.2,2846730,2698106,148624,5.2
1988,Dec,67.8,64.4,2850767,2707064,143703,5
1989,Jan,67.8,64.6,2852800,2715047,137753,4.8
1989,Feb,67.8,64.7,2854168,2721741,132427,4.6
1989,Mar,67.9,64.8,2855935,2727341,128594,4.5
1989,Apr,67.9,64.9,2858230,2731348,126882,4.4
1989,May,67.9,64.9,2860534,2732711,127823,4.5
1989,Jun,67.9,64.8,2862325,2730999,131326,4.6
1989,Jul,67.9,64.6,2862604,2726054,136550,4.8
1989,Aug,67.8,64.4,2860860,2718897,141963,5
1989,Sep,67.7,64.2,2857692,2711314,146378,5.1
1989,Oct,67.6,64,2854759,2705303,149456,5.2
1989,Nov,67.5,63.9,2852671,2701340,151331,5.3
1989,Dec,67.4,63.8,2850949,2698662,152287,5.3
1990,Jan,69,65.4,2848060,2695795,152265,5.3
1990,Feb,68.7,65.1,2842186,2691320,150866,5.3
1990,Mar,68.3,64.7,2833401,2684675,148726,5.2
1990,Apr,67.9,64.3,2823273,2676492,146781,5.2
1990,May,67.4,63.9,2813732,2668545,145187,5.2
1990,Jun,67,63.6,2805987,2661973,144014,5.1
1990,Jul,66.7,63.3,2801456,2657767,143689,5.1
1990,Aug,66.6,63.2,2800070,2655407,144663,5.2
1990,Sep,66.6,63.1,2799842,2652860,146982,5.2
1990,Oct,66.5,62.9,2799521,2648412,151109,5.4
1990,Nov,66.4,62.7,2799057,2642320,156737,5.6
1990,Dec,66.3,62.5,2798692,2635909,162783,5.8
1991,Jan,66.3,62.3,2798969,2630194,168775,6
1991,Feb,66.3,62.2,2800192,2626319,173873,6.2
1991,Mar,66.2,62.1,2800796,2624169,176627,6.3
1991,Apr,66.2,62,2799606,2623524,176082,6.3
1991,May,66,62,2796779,2624063,172716,6.2
1991,Jun,65.9,61.9,2792926,2625222,167704,6
1991,Jul,65.7,61.9,2788682,2626173,162509,5.8
1991,Aug,65.6,61.8,2785489,2626688,158801,5.7
1991,Sep,65.5,61.8,2784966,2627293,157673,5.7
1991,Oct,65.5,61.7,2787084,2628130,158954,5.7
1991,Nov,65.5,61.7,2791360,2629396,161964,5.8
1991,Dec,65.6,61.7,2797631,2631369,166262,5.9
1992,Jan,65.7,61.7,2805908,2634698,171210,6.1
1992,Feb,66,61.8,2816632,2639844,176788,6.3
1992,Mar,66.2,61.9,2830253,2647326,182927,6.5
1992,Apr,66.5,62.1,2845809,2656399,189410,6.7
1992,May,66.8,62.3,2860306,2665223,195083,6.8
1992,Jun,67,62.4,2870976,2672516,198460,6.9
1992,Jul,67.1,62.4,2876744,2677801,198943,6.9
1992,Aug,67,62.4,2877736,2681231,196505,6.8
1992,Sep,66.9,62.4,2875676,2683636,192040,6.7
1992,Oct,66.7,62.4,2873437,2686642,186795,6.5
1992,Nov,66.7,62.4,2873327,2691292,182035,6.3
1992,Dec,66.7,62.5,2877036,2698432,178604,6.2
1993,Jan,66.8,62.7,2885713,2708927,176786,6.1
1993,Feb,67.1,63,2899070,2722728,176342,6.1
1993,Mar,67.4,63.3,2916070,2739262,176808,6.1
1993,Apr,67.8,63.7,2934876,2757316,177560,6.1
1993,May,68.1,64,2954003,2775132,178871,6.1
1993,Jun,68.5,64.3,2972534,2791289,181245,6.1
1993,Jul,67.8,64.6,2946852,2804941,141911,4.8
1993,Aug,67.8,64.8,2949112,2816216,132896,4.5
1993,Sep,68,64.9,2959751,2826047,133704,4.5
1993,Oct,68.2,65.1,2973450,2835196,138254,4.6
1993,Nov,68.5,65.2,2988376,2843920,144456,4.8
1993,Dec,68.8,65.4,3002784,2852530,150254,5
1994,Jan,69,65.5,3014477,2860807,153670,5.1
1994,Feb,69.2,65.6,3022132,2868029,154103,5.1
1994,Mar,69.2,65.7,3026656,2874039,152617,5
1994,Apr,69.2,65.8,3030504,2879961,150543,5
1994,May,69.3,65.9,3036489,2887486,149003,4.9
1994,Jun,69.5,66.1,3046306,2897639,148667,4.9
1994,Jul,69.8,66.4,3060290,2910901,149389,4.9
1994,Aug,70.1,66.7,3076833,2926870,149963,4.9
1994,Sep,70.4,67,3093353,2944368,148985,4.8
1994,Oct,70.6,67.3,3107720,2961943,145777,4.7
1994,Nov,70.8,67.6,3119559,2978109,141450,4.5
1994,Dec,71,67.9,3128865,2990586,138279,4.4
1995,Jan,71.1,68,3135383,2997531,137852,4.4
1995,Feb,71.1,68,3139472,2999377,140095,4.5
1995,Mar,71.1,67.9,3141204,2997461,143743,4.6
1995,Apr,71,67.7,3140734,2993570,147164,4.7
1995,May,71,67.6,3138922,2990075,148847,4.7
1995,Jun,70.8,67.5,3136886,2988599,148287,4.7
1995,Jul,70.7,67.4,3135418,2989256,146162,4.7
1995,Aug,70.7,67.4,3134524,2990658,143866,4.6
1995,Sep,70.6,67.3,3133643,2990971,142672,4.6
1995,Oct,70.4,67.2,3131750,2989006,142744,4.6
1995,Nov,70.3,67.1,3127663,2984720,142943,4.6
1995,Dec,70.1,66.9,3121867,2979375,142492,4.6
1996,Jan,69.9,66.7,3116286,2974972,141314,4.5
1996,Feb,69.8,66.6,3112289,2972623,139666,4.5
1996,Mar,69.7,66.6,3110346,2972648,137698,4.4
1996,Apr,69.6,66.6,3110301,2974803,135498,4.4
1996,May,69.6,66.6,3111383,2978378,133005,4.3
1996,Jun,69.5,66.6,3112535,2982603,129932,4.2
1996,Jul,69.5,66.7,3112948,2986738,126210,4.1
1996,Aug,69.4,66.7,3112171,2990329,121842,3.9
1996,Sep,69.3,66.7,3109758,2992760,116998,3.8
1996,Oct,69.2,66.7,3106305,2993675,112630,3.6
1996,Nov,69,66.6,3103157,2993736,109421,3.5
1996,Dec,69,66.6,3101376,2994051,107325,3.5
1997,Jan,68.9,66.6,3101595,2995311,106284,3.4
1997,Feb,69,66.6,3104132,2998120,106012,3.4
1997,Mar,69.1,66.7,3108972,3002840,106132,3.4
1997,Apr,69.2,66.8,3115443,3008569,106874,3.4
1997,May,69.3,66.9,3121884,3013603,108281,3.5
1997,Jun,69.4,66.9,3126957,3016917,110040,3.5
1997,Jul,69.4,66.9,3130112,3018450,111662,3.6
1997,Aug,69.4,66.9,3131417,3018608,112809,3.6
1997,Sep,69.3,66.8,3131239,3018252,112987,3.6
1997,Oct,69.2,66.8,3130012,3017898,112114,3.6
1997,Nov,69.2,66.7,3127725,3017600,110125,3.5
1997,Dec,69.1,66.7,3124719,3017732,106987,3.4
1998,Jan,69,66.7,3121548,3018585,102963,3.3
1998,Feb,68.9,66.7,3118659,3020017,98642,3.2
1998,Mar,68.8,66.7,3116016,3021345,94671,3
1998,Apr,68.7,66.7,3114166,3022521,91645,2.9
1998,May,68.7,66.7,3113918,3023643,90275,2.9
1998,Jun,68.7,66.7,3115581,3024611,90970,2.9
1998,Jul,68.7,66.7,3119336,3025787,93549,3
1998,Aug,68.8,66.7,3124549,3027659,96890,3.1
1998,Sep,68.9,66.7,3130006,3030144,99862,3.2
1998,Oct,68.9,66.7,3133971,3033002,100969,3.2
1998,Nov,68.9,66.7,3135192,3035440,99752,3.2
1998,Dec,68.8,66.7,3133730,3036603,97127,3.1
1999,Jan,68.7,66.6,3130519,3036430,94089,3
1999,Feb,68.6,66.6,3127016,3035336,91680,2.9
1999,Mar,68.5,66.5,3124303,3033873,90430,2.9
1999,Apr,68.5,66.5,3122505,3032170,90335,2.9
1999,May,68.4,66.4,3121414,3030219,91195,2.9
1999,Jun,68.3,66.3,3121096,3028285,92811,3
1999,Jul,68.3,66.2,3121333,3026442,94891,3
1999,Aug,68.3,66.2,3122239,3025310,96929,3.1
1999,Sep,68.3,66.1,3124297,3025740,98557,3.2
1999,Oct,68.3,66.1,3127714,3027828,99886,3.2
1999,Nov,68.4,66.2,3132473,3031506,100967,3.2
1999,Dec,68.4,66.2,3137297,3035707,101590,3.2
2000,Jan,68.5,66.2,3140872,3038921,101951,3.2
2000,Feb,68.5,66.3,3142328,3040007,102321,3.3
2000,Mar,68.4,66.2,3141711,3038627,103084,3.3
2000,Apr,68.4,66.1,3139239,3035362,103877,3.3
2000,May,68.2,66,3134814,3031166,103648,3.3
2000,Jun,68,65.8,3128446,3026717,101729,3.3
2000,Jul,67.8,65.7,3120861,3022816,98045,3.1
2000,Aug,67.6,65.6,3114439,3020538,93901,3
2000,Sep,67.5,65.5,3111328,3020438,90890,2.9
2000,Oct,67.5,65.6,3112778,3022675,90103,2.9
2000,Nov,67.6,65.6,3118715,3026371,92344,3
2000,Dec,67.8,65.6,3127358,3030003,97355,3.1
2001,Jan,67.9,65.7,3135745,3031881,103864,3.3
2001,Feb,68,65.6,3141119,3030873,110246,3.5
2001,Mar,68,65.5,3141853,3026628,115225,3.7
2001,Apr,67.9,65.3,3138325,3019645,118680,3.8
2001,May,67.7,65.1,3133405,3011731,121674,3.9
2001,Jun,67.6,64.9,3130095,3004675,125420,4
2001,Jul,67.6,64.8,3130456,2999665,130791,4.2
2001,Aug,67.6,64.7,3134052,2996062,137990,4.4
2001,Sep,67.7,64.6,3139525,2993175,146350,4.7
2001,Oct,67.8,64.5,3145459,2990765,154694,4.9
2001,Nov,67.9,64.4,3150115,2988362,161753,5.1
2001,Dec,67.9,64.3,3153290,2986435,166855,5.3
2002,Jan,67.9,64.3,3155451,2985585,169866,5.4
2002,Feb,67.9,64.3,3157267,2986289,170978,5.4
2002,Mar,68,64.3,3159782,2989064,170718,5.4
2002,Apr,68,64.4,3163949,2994416,169533,5.4
2002,May,68.1,64.5,3169536,3001795,167741,5.3
2002,Jun,68.2,64.7,3175468,3009878,165590,5.2
2002,Jul,68.3,64.8,3180125,3016720,163405,5.1
2002,Aug,68.3,64.8,3182504,3021222,161282,5.1
2002,Sep,68.2,64.8,3182517,3023022,159495,5
2002,Oct,68.1,64.8,3180483,3022157,158326,5
2002,Nov,68,64.7,3177768,3020076,157692,5
2002,Dec,68,64.6,3175462,3018102,157360,5
2003,Jan,67.9,64.5,3175008,3017370,157638,5
2003,Feb,67.9,64.5,3177109,3018046,159063,5
2003,Mar,68,64.5,3181064,3019116,161948,5.1
2003,Apr,68.1,64.5,3185330,3019237,166093,5.2
2003,May,68.1,64.4,3188522,3017724,170798,5.4
2003,Jun,68.1,64.3,3190180,3015384,174796,5.5
2003,Jul,68,64.3,3190012,3013169,176843,5.5
2003,Aug,68,64.2,3188102,3011488,176614,5.5
2003,Sep,67.8,64.1,3184605,3010332,174273,5.5
2003,Oct,67.7,64.1,3180237,3009312,170925,5.4
2003,Nov,67.6,64,3175902,3007958,167944,5.3
2003,Dec,67.5,63.9,3172180,3005983,166197,5.2
2004,Jan,67.4,63.9,3168939,3003260,165679,5.2
2004,Feb,67.3,63.8,3166416,3000488,165928,5.2
2004,Mar,67.3,63.7,3165167,2998676,166491,5.3
2004,Apr,67.2,63.7,3164871,2998069,166802,5.3
2004,May,67.2,63.7,3165030,2998256,166774,5.3
2004,Jun,67.2,63.6,3165341,2998500,166841,5.3
2004,Jul,67.1,63.6,3165795,2998333,167462,5.3
2004,Aug,67.1,63.5,3166201,2997474,168727,5.3
2004,Sep,67.1,63.4,3166907,2996056,170851,5.4
2004,Oct,67,63.4,3168297,2994573,173724,5.5
2004,Nov,67,63.3,3170421,2993770,176651,5.6
2004,Dec,67.1,63.3,3173825,2994692,179133,5.6
2005,Jan,67.1,63.3,3178412,2997944,180468,5.7
2005,Feb,67.2,63.4,3183374,3003185,180189,5.7
2005,Mar,67.3,63.5,3188035,3009890,178145,5.6
2005,Apr,67.3,63.6,3192780,3017533,175247,5.5
2005,May,67.4,63.7,3198004,3025423,172581,5.4
2005,Jun,67.5,63.8,3203640,3032446,171194,5.3
2005,Jul,67.5,63.9,3209557,3037643,171914,5.4
2005,Aug,67.6,63.9,3215056,3041156,173900,5.4
2005,Sep,67.6,63.9,3219388,3043851,175537,5.5
2005,Oct,67.6,63.9,3222419,3047022,175397,5.4
2005,Nov,67.6,63.9,3224519,3051236,173283,5.4
2005,Dec,67.6,64,3226016,3056016,170000,5.3
2006,Jan,67.5,64.1,3227663,3061006,166657,5.2
2006,Feb,67.5,64.1,3229879,3065503,164376,5.1
2006,Mar,67.6,64.1,3232615,3068590,164025,5.1
2006,Apr,67.6,64.1,3235137,3069699,165438,5.1
2006,May,67.6,64.1,3236605,3069259,167346,5.2
2006,Jun,67.5,64,3236652,3068156,168496,5.2
2006,Jul,67.5,64,3236044,3068080,167964,5.2
2006,Aug,67.4,63.9,3236193,3070006,166187,5.1
2006,Sep,67.4,64,3237300,3073292,164008,5.1
2006,Oct,67.3,64,3238470,3077143,161327,5
2006,Nov,67.3,64,3238820,3080502,158318,4.9
2006,Dec,67.2,64,3236893,3081907,154986,4.8
2007,Jan,67.1,63.9,3231991,3080328,151663,4.7
2007,Feb,66.9,63.8,3224578,3075991,148587,4.6
2007,Mar,66.7,63.6,3215324,3069729,145595,4.5
2007,Apr,66.4,63.4,3206022,3062945,143077,4.5
2007,May,66.2,63.3,3198577,3056864,141713,4.4
2007,Jun,66.1,63.1,3194344,3052594,141750,4.4
2007,Jul,66,63.1,3193793,3050705,143088,4.5
2007,Aug,66,63,3196437,3051184,145253,4.5
2007,Sep,66.1,63,3201296,3054043,147253,4.6
2007,Oct,66.1,63.1,3206853,3058004,148849,4.6
2007,Nov,66.2,63.1,3211381,3061704,149677,4.7
2007,Dec,66.2,63.1,3214364,3064603,149761,4.7
2008,Jan,66.2,63.1,3215956,3065927,150029,4.7
2008,Feb,66.2,63.1,3217041,3065481,151560,4.7
2008,Mar,66.2,63,3219448,3063877,155571,4.8
2008,Apr,66.2,62.9,3223835,3061677,162158,5
2008,May,66.3,62.8,3229861,3059324,170537,5.3
2008,Jun,66.4,62.7,3236303,3056722,179581,5.5
2008,Jul,66.5,62.6,3241356,3052757,188599,5.8
2008,Aug,66.5,62.4,3243996,3045898,198098,6.1
2008,Sep,66.4,62.2,3244148,3034594,209554,6.5
2008,Oct,66.4,61.8,3242652,3018183,224469,6.9
2008,Nov,66.3,61.3,3240128,2997029,243099,7.5
2008,Dec,66.2,60.8,3236984,2972558,264426,8.2
2009,Jan,66.1,60.2,3233684,2947163,286521,8.9
2009,Feb,66,59.7,3230361,2923493,306868,9.5
2009,Mar,65.9,59.3,3226201,2903578,322623,10
2009,Apr,65.7,58.9,3220409,2888020,332389,10.3
2009,May,65.5,58.7,3212459,2875512,336947,10.5
2009,Jun,65.3,58.4,3202508,2864618,337890,10.6
2009,Jul,65,58.2,3190972,2854170,336802,10.6
2009,Aug,64.7,57.9,3178722,2843631,335091,10.5
2009,Sep,64.5,57.7,3167706,2833578,334128,10.5
2009,Oct,64.2,57.4,3159513,2824731,334782,10.6
2009,Nov,64.1,57.3,3156429,2818715,337714,10.7
2009,Dec,64.2,57.2,3159417,2816984,342433,10.8
2010,Jan,64.3,57.2,3166341,2819597,346744,11
2010,Feb,64.4,57.3,3174143,2825320,348823,11
2010,Mar,64.5,57.5,3181033,2832872,348161,10.9
2010,Apr,64.2,57.2,3185758,2840912,344846,10.8
2010,May,64.2,57.4,3187271,2848122,339149,10.6
2010,Jun,64.1,57.4,3185465,2852903,332562,10.4
2010,Jul,64,57.4,3181242,2854586,326656,10.3
2010,Aug,63.8,57.4,3176046,2854268,321778,10.1
2010,Sep,63.7,57.3,3170732,2853388,317344,10
2010,Oct,63.6,57.3,3166143,2853952,312191,9.9
2010,Nov,63.5,57.3,3162275,2856852,305423,9.7
2010,Dec,63.4,57.4,3159427,2862029,297398,9.4
2011,Jan,63.3,57.5,3158887,2869164,289723,9.2
2011,Feb,63.3,57.6,3160522,2876584,283938,9
2011,Mar,63.4,57.7,3163109,2882053,281056,8.9
2011,Apr,63.4,57.7,3166405,2884769,281636,8.9
2011,May,63.5,57.7,3171288,2885793,285495,9
2011,Jun,63.6,57.7,3177867,2886780,291087,9.2
2011,Jul,63.7,57.7,3185643,2889288,296355,9.3
2011,Aug,63.8,57.8,3193257,2893693,299564,9.4
2011,Sep,63.9,57.9,3199028,2899629,299399,9.4
2011,Oct,63.9,58,3202015,2906222,295793,9.2
2011,Nov,63.8,58.1,3201209,2911729,289480,9
2011,Dec,63.7,58.1,3196276,2914603,281673,8.8
2012,Jan,63.5,58.1,3188316,2914437,273879,8.6
2012,Feb,63.3,58,3179585,2911957,267628,8.4
2012,Mar,63.2,57.9,3171742,2907822,263920,8.3
2012,Apr,63,57.8,3165417,2902880,262537,8.3
2012,May,62.9,57.7,3161347,2898841,262506,8.3
2012,Jun,62.8,57.6,3159779,2897215,262564,8.3
2012,Jul,62.8,57.6,3160387,2898371,262016,8.3
2012,Aug,62.8,57.6,3163069,2901505,261564,8.3
2012,Sep,62.9,57.7,3167606,2905442,262164,8.3
2012,Oct,62.9,57.7,3172520,2908732,263788,8.3
2012,Nov,63,57.7,3176648,2910893,265755,8.4
2012,Dec,63,57.7,3179250,2912145,267105,8.4
2013,Jan,63,57.7,3182174,2912845,269329,8.5
2013,Feb,63,57.7,3181912,2914139,267773,8.4
2013,Mar,63,57.7,3181709,2917519,264190,8.3
2013,Apr,63,57.8,3182826,2923774,259052,8.1
2013,May,63,58,3184914,2931401,253513,8
2013,Jun,63,58.1,3187584,2939083,248501,7.8
2013,Jul,63,58.2,3190762,2946803,243959,7.6
2013,Aug,63,58.3,3192815,2954613,238202,7.5
2013,Sep,63,58.4,3192847,2962355,230492,7.2
2013,Oct,62.9,58.5,3192201,2970053,222148,7
2013,Nov,62.9,58.7,3192528,2978018,214510,6.7
2013,Dec,62.9,58.8,3194641,2986237,208404,6.5
2014,Jan,63,59,3199151,2994670,204481,6.4
2014,Feb,63,59.1,3203824,3002769,201055,6.3
2014,Mar,63.1,59.2,3209321,3010315,199006,6.2
2014,Apr,63.2,59.3,3214399,3016674,197725,6.2
2014,May,63.3,59.4,3218745,3022683,196062,6.1
2014,Jun,63.3,59.5,3222954,3029273,193681,6
2014,Jul,63.4,59.6,3226932,3035963,190969,5.9
2014,Aug,63.4,59.7,3231964,3043026,188938,5.8
2014,Sep,63.5,59.8,3238381,3050622,187759,5.8
2014,Oct,63.6,60,3244080,3057914,186166,5.7
2014,Nov,63.6,60,3247234,3063870,183364,5.6
2014,Dec,63.6,60.1,3248080,3068507,179573,5.5
2015,Jan,63.6,60.2,3247783,3072369,175414,5.4
2015,Feb,63.6,60.3,3247936,3076733,171203,5.3
2015,Mar,63.6,60.4,3249304,3082274,167030,5.1
2015,Apr,63.7,60.5,3252270,3089276,162994,5
2015,May,63.7,60.6,3256167,3096985,159182,4.9
2015,Jun,63.8,60.7,3259977,3104396,155581,4.8
2015,Jul,63.8,60.8,3263980,3111489,152491,4.7
2015,Aug,63.9,60.9,3268583,3118417,150166,4.6
2015,Sep,63.9,61,3274389,3125757,148632,4.5
2015,Oct,64.1,61.2,3283084,3134656,148428,4.5
2015,Nov,64.3,61.4,3295081,3145123,149958,4.6
2015,Dec,64.5,61.5,3308421,3155917,152504,4.6
2016,Jan,64.7,61.7,3320240,3165306,154934,4.7
2016,Feb,64.8,61.8,3328783,3172241,156542,4.7
2016,Mar,64.9,61.9,3333489,3176736,156753,4.7
2016,Apr,64.9,61.9,3335181,3179546,155635,4.7
2016,May,64.9,61.9,3335255,3181697,153558,4.6
2016,Jun,64.8,61.9,3334355,3183653,150702,4.5
2016,Jul,64.7,61.9,3332623,3185360,147263,4.4
2016,Aug,64.7,61.9,3330464,3186486,143978,4.3
2016,Sep,64.6,61.9,3328358,3186749,141609,4.3
2016,Oct,64.5,61.8,3325869,3186208,139661,4.2
2016,Nov,64.4,61.8,3323069,3186061,137008,4.1
2016,Dec,64.4,61.8,3320863,3187493,133370,4
2017,Jan,64.3,61.8,3320158,3191055,129103,3.9
2017,Feb,64.3,61.9,3320973,3196536,124437,3.7
2017,Mar,64.3,62,3322744,3202420,120324,3.6
2017,Apr,64.4,62.1,3325547,3207896,117651,3.5
2017,May,64.4,62.1,3329235,3212573,116662,3.5
2017,Jun,64.5,62.2,3333454,3216178,117276,3.5
2017,Jul,64.5,62.2,3337942,3219150,118792,3.6
2017,Aug,64.5,62.2,3341454,3221814,119640,3.6
2017,Sep,64.5,62.2,3343190,3224415,118775,3.6
2017,Oct,64.5,62.2,3343693,3227318,116375,3.5
2017,Nov,64.5,62.3,3344001,3230467,113534,3.4
2017,Dec,64.5,62.3,3345485,3234218,111267,3.3
2018,Jan,64.5,62.4,3349616,3238977,110639,3.3
2018,Feb,64.6,62.5,3357086,3244966,112120,3.3
2018,Mar,64.8,62.6,3366816,3251915,114901,3.4
2018,Apr,64.9,62.7,3375897,3258333,117564,3.5
2018,May,65,62.7,3382443,3263063,119380,3.5
2018,Jun,65,62.7,3386296,3266249,120047,3.5
2018,Jul,65,62.7,3387859,3268182,119677,3.5
2018,Aug,65,62.7,3389067,3269817,119250,3.5
2018,Sep,65,62.7,3391666,3272316,119350,3.5
2018,Oct,65,62.7,3395964,3275878,120086,3.5
2018,Nov,65.1,62.8,3401009,3279775,121234,3.6
2018,Dec,65.1,62.8,3404551,3282427,122124,3.6
2019,Jan,65.1,62.8,3404310,3282340,121970,3.6
2019,Feb,65,62.7,3399291,3278775,120516,3.5
2019,Mar,64.8,62.5,3391039,3272809,118230,3.5
2019,Apr,64.6,62.4,3382499,3266910,115589,3.4
2019,May,64.4,62.3,3376225,3263234,112991,3.3
2019,Jun,64.3,62.2,3373873,3263061,110812,3.3
2019,Jul,64.3,62.3,3376195,3266943,109252,3.2
2019,Aug,64.4,62.3,3380901,3272718,108183,3.2
2019,Sep,64.4,62.4,3386110,3278500,107610,3.2
2019,Oct,64.5,62.4,3389444,3282061,107383,3.2
2019,Nov,64.4,62.4,3389478,3281975,107503,3.2
2019,Dec,64.4,62.3,3388859,3281209,107650,3.2
2020,Jan,64.4,62.4,3392922,3286146,106776,3.1
2020,Feb,64.4,62.5,3396229,3291040,105189,3.1
2020,Mar,62.2,60.3,3277678,3177786,99892,3
2020,Apr,61.2,50.4,3226630,2660808,565822,17.5
2020,May,63.3,55.5,3340305,2930891,409414,12.3
2020,Jun,64.3,57.1,3393875,3017294,376581,11.1
2020,Jul,62.8,57.8,3318673,3057572,261101,7.9
2020,Aug,63.5,59.4,3356226,3141656,214570,6.4
2020,Sep,63,59.1,3336535,3128254,208281,6.2
