Year,Period,labor force participation rate,employment-population ratio,labor force,employment,unemployment,unemployment rate
1976,Jan,71.5,65.1,322417,293574,28843,8.9
1976,Feb,71,64.6,322146,293280,28866,9
1976,Mar,70.7,64.4,322327,293456,28871,9
1976,Apr,70.7,64.4,323929,295160,28769,8.9
1976,May,70.9,64.7,326152,297525,28627,8.8
1976,Jun,71.1,64.9,328597,300068,28529,8.7
1976,Jul,71.3,65.1,330705,302176,28529,8.6
1976,Aug,71.3,65.2,332310,303615,28695,8.6
1976,Sep,71.1,65,333660,304702,28958,8.7
1976,Oct,71.1,64.9,334967,305782,29185,8.7
1976,Nov,71,64.8,336500,307230,29270,8.7
1976,Dec,71.1,65,338319,309221,29098,8.6
1977,Jan,71.2,65.2,340412,311743,28669,8.4
1977,Feb,71.2,65.4,342653,314641,28012,8.2
1977,Mar,71.4,65.8,344802,317643,27159,7.9
1977,Apr,71.3,65.9,346682,320508,26174,7.5
1977,May,71.4,66.2,348213,323094,25119,7.2
1977,Jun,71.2,66.3,349482,325440,24042,6.9
1977,Jul,71.1,66.5,350702,327739,22963,6.5
1977,Aug,71,66.6,352106,330216,21890,6.2
1977,Sep,70.9,66.7,353852,332987,20865,5.9
1977,Oct,70.9,66.9,355912,335996,19916,5.6
1977,Nov,70.9,67.1,358119,339089,19030,5.3
1977,Dec,70.9,67.3,360339,342115,18224,5.1
1978,Jan,70.9,67.5,362466,345000,17466,4.8
1978,Feb,70.8,67.5,364501,347724,16777,4.6
1978,Mar,70.8,67.6,366570,350362,16208,4.4
1978,Apr,70.8,67.7,368767,352956,15811,4.3
1978,May,70.8,67.8,371102,355461,15641,4.2
1978,Jun,70.9,67.9,373460,357752,15708,4.2
1978,Jul,70.9,67.9,375611,359622,15989,4.3
1978,Aug,70.8,67.7,377357,360940,16417,4.4
1978,Sep,70.5,67.4,378642,361760,16882,4.5
1978,Oct,70.3,67.1,379689,362387,17302,4.6
1978,Nov,70.1,66.9,380844,363201,17643,4.6
1978,Dec,70,66.7,382352,364443,17909,4.7
1979,Jan,69.9,66.6,384374,366192,18182,4.7
1979,Feb,70,66.6,386963,368422,18541,4.8
1979,Mar,70.1,66.7,389988,370991,18997,4.9
1979,Apr,70.3,66.9,393227,373723,19504,5
1979,May,70.4,66.9,396502,376524,19978,5
1979,Jun,70.6,67,399693,379309,20384,5.1
1979,Jul,70.8,67.2,402780,382147,20633,5.1
1979,Aug,70.9,67.3,405771,385105,20666,5.1
1979,Sep,70.9,67.4,408637,388120,20517,5
1979,Oct,71,67.5,411311,391024,20287,4.9
1979,Nov,71,67.5,413727,393610,20117,4.9
1979,Dec,71,67.5,415856,395699,20157,4.8
1980,Jan,70.9,67.4,417663,397125,20538,4.9
1980,Feb,70.7,67.1,419176,397851,21325,5.1
1980,Mar,70.6,66.8,420579,398042,22537,5.4
1980,Apr,70.4,66.3,422154,398075,24079,5.7
1980,May,70.4,66.2,424107,398389,25718,6.1
1980,Jun,70.5,66,426524,399399,27125,6.4
1980,Jul,70.7,66.1,429402,401245,28157,6.6
1980,Aug,71,66.3,432623,403757,28866,6.7
1980,Sep,71.2,66.4,435990,406621,29369,6.7
1980,Oct,71.5,66.7,439262,409424,29838,6.8
1980,Nov,71.8,66.9,442286,411925,30361,6.9
1980,Dec,71.9,66.9,445120,414193,30927,6.9
1981,Jan,72.1,67.1,447864,416433,31431,7
1981,Feb,72.3,67.2,450527,418789,31738,7
1981,Mar,72.4,67.3,453137,421386,31751,7
1981,Apr,72.6,67.6,455724,424216,31508,6.9
1981,May,72.8,67.8,458348,427119,31229,6.8
1981,Jun,72.8,67.9,461140,429928,31212,6.8
1981,Jul,73.1,68.1,464157,432491,31666,6.8
1981,Aug,73.4,68.2,467365,434744,32621,7
1981,Sep,73.7,68.3,470672,436661,34011,7.2
1981,Oct,73.9,68.4,473885,438230,35655,7.5
1981,Nov,74.1,68.3,476738,439304,37434,7.9
1981,Dec,74.3,68.2,479009,439737,39272,8.2
1982,Jan,74.3,67.9,480636,439579,41057,8.5
1982,Feb,74.1,67.5,481713,438991,42722,8.9
1982,Mar,74,67.2,482313,438077,44236,9.2
1982,Apr,73.8,66.8,482537,436965,45572,9.4
1982,May,73.6,66.4,482509,435801,46708,9.7
1982,Jun,73.3,66,482286,434605,47681,9.9
1982,Jul,73,65.7,481986,433425,48561,10.1
1982,Aug,72.9,65.4,481786,432368,49418,10.3
1982,Sep,72.8,65.2,481801,431507,50294,10.4
1982,Oct,72.7,65,482090,430901,51189,10.6
1982,Nov,72.7,64.9,482655,430711,51944,10.8
1982,Dec,72.7,64.8,483360,430987,52373,10.8
1983,Jan,72.8,64.9,484050,431650,52400,10.8
1983,Feb,72.8,65,484632,432647,51985,10.7
1983,Mar,72.7,65.1,485044,433885,51159,10.5
1983,Apr,72.6,65.2,485282,435244,50038,10.3
1983,May,72.6,65.3,485403,436638,48765,10
1983,Jun,72.5,65.4,485521,438080,47441,9.8
1983,Jul,72.4,65.5,485705,439608,46097,9.5
1983,Aug,72.2,65.6,485979,441237,44742,9.2
1983,Sep,72.2,65.7,486412,443015,43397,8.9
1983,Oct,72.1,65.8,487071,444991,42080,8.6
1983,Nov,72,65.9,487951,447095,40856,8.4
1983,Dec,72,66.2,489057,449259,39798,8.1
1984,Jan,72,66.3,490402,451453,38949,7.9
1984,Feb,72,66.4,491958,453583,38375,7.8
1984,Mar,72.2,66.6,493688,455564,38124,7.7
1984,Apr,72.2,66.7,495525,457319,38206,7.7
1984,May,72.3,66.7,497413,458840,38573,7.8
1984,Jun,72.5,66.8,499262,460170,39092,7.8
1984,Jul,72.5,66.8,500977,461348,39629,7.9
1984,Aug,72.4,66.6,502528,462434,40094,8
1984,Sep,72.3,66.5,503907,463500,40407,8
1984,Oct,72.3,66.5,505210,464667,40543,8
1984,Nov,72.2,66.4,506627,466050,40577,8
1984,Dec,72.1,66.3,508270,467666,40604,8
1985,Jan,72,66.3,510083,469377,40706,8
1985,Feb,72,66.3,511922,471039,40883,8
1985,Mar,71.9,66.2,513599,472564,41035,8
1985,Apr,71.9,66.2,514955,473919,41036,8
1985,May,71.8,66.1,515948,475109,40839,7.9
1985,Jun,71.6,66,516655,476169,40486,7.8
1985,Jul,71.3,65.8,517220,477151,40069,7.7
1985,Aug,71.3,65.9,517769,478151,39618,7.7
1985,Sep,71.3,65.9,518315,479223,39092,7.5
1985,Oct,71.4,66.1,518850,480381,38469,7.4
1985,Nov,71.3,66.2,519395,481649,37746,7.3
1985,Dec,71.3,66.3,520026,483113,36913,7.1
1986,Jan,71.3,66.4,520848,484868,35980,6.9
1986,Feb,71.4,66.6,521965,486954,35011,6.7
1986,Mar,71.5,66.8,523454,489330,34124,6.5
1986,Apr,71.8,67.2,525289,491905,33384,6.4
1986,May,71.9,67.5,527355,494554,32801,6.2
1986,Jun,72.1,67.7,529545,497187,32358,6.1
1986,Jul,72.3,68,531760,499747,32013,6
1986,Aug,72.3,68,533935,502164,31771,6
1986,Sep,72.5,68.2,536132,504422,31710,5.9
1986,Oct,72.5,68.2,538345,506518,31827,5.9
1986,Nov,72.5,68.2,540451,508401,32050,5.9
1986,Dec,72.5,68.2,542455,510104,32351,6
1987,Jan,72.6,68.2,544410,511724,32686,6
1987,Feb,72.6,68.2,546364,513356,33008,6
1987,Mar,72.6,68.2,548395,515094,33301,6.1
1987,Apr,72.6,68.2,550579,517004,33575,6.1
1987,May,72.7,68.3,552882,519056,33826,6.1
1987,Jun,72.8,68.3,555200,521152,34048,6.1
1987,Jul,72.9,68.4,557482,523232,34250,6.1
1987,Aug,72.9,68.4,559689,525291,34398,6.1
1987,Sep,72.9,68.4,561793,527387,34406,6.1
1987,Oct,72.8,68.4,563774,529557,34217,6.1
1987,Nov,72.8,68.5,565706,531895,33811,6
1987,Dec,72.8,68.5,567613,534404,33209,5.9
1988,Jan,72.7,68.6,569534,537012,32522,5.7
1988,Feb,72.7,68.7,571552,539683,31869,5.6
1988,Mar,72.7,68.7,573702,542363,31339,5.5
1988,Apr,72.7,68.8,576017,545019,30998,5.4
1988,May,72.8,68.9,578536,547721,30815,5.3
1988,Jun,72.8,69,581245,550557,30688,5.3
1988,Jul,72.9,69.1,583965,553496,30469,5.2
1988,Aug,72.9,69.2,586472,556362,30110,5.1
1988,Sep,72.8,69.2,588619,558935,29684,5
1988,Oct,72.8,69.2,590377,561111,29266,5
1988,Nov,72.6,69.1,591841,562918,28923,4.9
1988,Dec,72.5,69,593141,564457,28684,4.8
1989,Jan,72.4,68.9,594464,565930,28534,4.8
1989,Feb,72.2,68.8,595921,567459,28462,4.8
1989,Mar,72.2,68.7,597528,569127,28401,4.8
1989,Apr,72,68.6,599187,570896,28291,4.7
1989,May,72,68.6,600807,572625,28182,4.7
1989,Jun,71.8,68.4,602354,574197,28157,4.7
1989,Jul,71.7,68.4,603937,575645,28292,4.7
1989,Aug,71.6,68.2,605830,577284,28546,4.7
1989,Sep,71.6,68.3,608234,579453,28781,4.7
1989,Oct,71.7,68.3,611232,582310,28922,4.7
1989,Nov,71.8,68.4,614660,585709,28951,4.7
1989,Dec,72,68.6,618205,589296,28909,4.7
1990,Jan,69.7,66.6,645004,616135,28869,4.5
1990,Feb,70.7,67.6,654981,626096,28885,4.4
1990,Mar,71.1,67.9,659761,630714,29047,4.4
1990,Apr,71.4,68.2,663019,633601,29418,4.4
1990,May,71.3,68.1,666005,636022,29983,4.5
1990,Jun,71.6,68.3,669120,638427,30693,4.6
1990,Jul,72,68.6,672451,640951,31500,4.7
1990,Aug,71.9,68.4,675807,643428,32379,4.8
1990,Sep,71.7,68.2,678932,645616,33316,4.9
1990,Oct,71.6,68,681725,647401,34324,5
1990,Nov,71.4,67.7,684328,648899,35429,5.2
1990,Dec,71.3,67.5,686957,650341,36616,5.3
1991,Jan,71.1,67.2,689732,651920,37812,5.5
1991,Feb,71,67.1,692653,653725,38928,5.6
1991,Mar,70.9,66.8,695485,655647,39838,5.7
1991,Apr,70.8,66.7,698070,657647,40423,5.8
1991,May,70.6,66.5,700387,659725,40662,5.8
1991,Jun,70.4,66.3,702420,661752,40668,5.8
1991,Jul,70.2,66.1,704212,663564,40648,5.8
1991,Aug,70.1,66,705954,665110,40844,5.8
1991,Sep,70,65.9,707897,666432,41465,5.9
1991,Oct,69.9,65.7,710115,667598,42517,6
1991,Nov,69.9,65.6,712547,668752,43795,6.1
1991,Dec,70,65.6,715131,670089,45042,6.3
1992,Jan,69.9,65.5,717774,671700,46074,6.4
1992,Feb,69.9,65.4,720378,673546,46832,6.5
1992,Mar,70,65.4,722940,675583,47357,6.6
1992,Apr,70,65.4,725498,677727,47771,6.6
1992,May,69.9,65.3,728008,679827,48181,6.6
1992,Jun,69.9,65.3,730537,681918,48619,6.7
1992,Jul,69.9,65.2,733130,684069,49061,6.7
1992,Aug,69.9,65.2,735724,686271,49453,6.7
1992,Sep,69.9,65.2,738238,688505,49733,6.7
1992,Oct,69.8,65.1,740705,690775,49930,6.7
1992,Nov,69.8,65.1,743153,692986,50167,6.8
1992,Dec,69.8,65.1,745620,695080,50540,6.8
1993,Jan,69.8,65,748352,697288,51064,6.8
1993,Feb,69.8,65,751539,699863,51676,6.9
1993,Mar,70,65.1,755205,702904,52301,6.9
1993,Apr,70.1,65.2,759078,706218,52860,7
1993,May,70.2,65.3,762904,709607,53297,7
1993,Jun,70.3,65.4,766585,713021,53564,7
1993,Jul,70.3,65.4,770108,716496,53612,7
1993,Aug,70.3,65.4,773715,720287,53428,6.9
1993,Sep,70.3,65.5,777739,724657,53082,6.8
1993,Oct,70.4,65.6,782333,729663,52670,6.7
1993,Nov,70.5,65.8,787380,735102,52278,6.6
1993,Dec,70.6,65.9,792584,740641,51943,6.6
1994,Jan,70.7,66.1,797406,745750,51656,6.5
1994,Feb,70.6,66.1,801349,749986,51363,6.4
1994,Mar,70.6,66.1,804322,753290,51032,6.3
1994,Apr,70.4,66,806611,755949,50662,6.3
1994,May,70.3,65.9,808627,758341,50286,6.2
1994,Jun,70.1,65.8,810660,760672,49988,6.2
1994,Jul,70,65.7,812969,763159,49810,6.1
1994,Aug,69.9,65.6,815468,765742,49726,6.1
1994,Sep,69.7,65.5,817886,768224,49662,6.1
1994,Oct,69.6,65.4,820080,770566,49514,6
1994,Nov,69.5,65.3,822112,772883,49229,6
1994,Dec,69.3,65.2,824048,775225,48823,5.9
1995,Jan,69.2,65.2,826043,777694,48349,5.9
1995,Feb,69.1,65.1,828389,780499,47890,5.8
1995,Mar,69,65.1,831228,783718,47510,5.7
1995,Apr,69,65.1,834551,787340,47211,5.7
1995,May,69,65.2,838290,791327,46963,5.6
1995,Jun,69,65.2,842284,795543,46741,5.5
1995,Jul,69.1,65.3,846279,799715,46564,5.5
1995,Aug,69.1,65.3,850080,803625,46455,5.5
1995,Sep,69.1,65.3,853603,807235,46368,5.4
1995,Oct,69,65.3,856786,810511,46275,5.4
1995,Nov,69,65.3,859721,813579,46142,5.4
1995,Dec,68.9,65.3,862728,816743,45985,5.3
1996,Jan,68.9,65.3,866076,820260,45816,5.3
1996,Feb,69,65.3,869913,824258,45655,5.2
1996,Mar,69,65.4,874238,828725,45513,5.2
1996,Apr,69.1,65.5,878959,833540,45419,5.2
1996,May,69.2,65.6,883886,838502,45384,5.1
1996,Jun,69.3,65.7,888858,843521,45337,5.1
1996,Jul,69.4,65.9,893786,848576,45210,5.1
1996,Aug,69.4,66,898683,853693,44990,5
1996,Sep,69.5,66.1,903538,858867,44671,4.9
1996,Oct,69.6,66.2,908370,864121,44249,4.9
1996,Nov,69.6,66.2,913103,869390,43713,4.8
1996,Dec,69.6,66.4,917595,874508,43087,4.7
1997,Jan,69.6,66.4,921772,879330,42442,4.6
1997,Feb,69.6,66.5,925608,883736,41872,4.5
1997,Mar,69.6,66.5,929129,887726,41403,4.5
1997,Apr,69.6,66.5,932467,891405,41062,4.4
1997,May,69.5,66.5,935714,894851,40863,4.4
1997,Jun,69.5,66.5,938889,898102,40787,4.3
1997,Jul,69.4,66.4,942001,901220,40781,4.3
1997,Aug,69.3,66.3,944991,904168,40823,4.3
1997,Sep,69.3,66.3,947759,906793,40966,4.3
1997,Oct,69.2,66.2,950290,909008,41282,4.3
1997,Nov,69.1,66.1,952674,910913,41761,4.4
1997,Dec,69.1,66,955125,912815,42310,4.4
1998,Jan,69,65.9,957873,915045,42828,4.5
1998,Feb,69,65.9,961074,917876,43198,4.5
1998,Mar,69.1,66,964734,921385,43349,4.5
1998,Apr,69.1,66,968721,925480,43241,4.5
1998,May,69.2,66.1,972876,930030,42846,4.4
1998,Jun,69.2,66.2,977090,934865,42225,4.3
1998,Jul,69.3,66.3,981231,939739,41492,4.2
1998,Aug,69.3,66.5,985209,944521,40688,4.1
1998,Sep,69.3,66.6,989018,949163,39855,4
1998,Oct,69.4,66.6,992644,953614,39030,3.9
1998,Nov,69.4,66.7,996125,957812,38313,3.8
1998,Dec,69.4,66.8,999515,961653,37862,3.8
1999,Jan,69.4,66.8,1002864,965084,37780,3.8
1999,Feb,69.5,66.8,1006217,968080,38137,3.8
1999,Mar,69.5,66.8,1009590,970678,38912,3.9
1999,Apr,69.5,66.7,1012891,972880,40011,4
1999,May,69.5,66.7,1016006,974770,41236,4.1
1999,Jun,69.5,66.6,1018871,976613,42258,4.1
1999,Jul,69.4,66.5,1021579,978812,42767,4.2
1999,Aug,69.4,66.5,1024377,981699,42678,4.2
1999,Sep,69.4,66.5,1027516,985386,42130,4.1
1999,Oct,69.4,66.6,1031088,989662,41426,4
1999,Nov,69.5,66.7,1035033,994160,40873,3.9
1999,Dec,69.5,66.8,1039185,998554,40631,3.9
2000,Jan,69.6,66.8,1043367,1002619,40748,3.9
2000,Feb,69.6,66.9,1047435,1006304,41131,3.9
2000,Mar,69.7,66.9,1051389,1009806,41583,4
2000,Apr,70,67.2,1055413,1013383,42030,4
2000,May,70,67.2,1059666,1017139,42527,4
2000,Jun,70.1,67.2,1064200,1020971,43229,4.1
2000,Jul,70.1,67.2,1068902,1024708,44194,4.1
2000,Aug,70.2,67.3,1073640,1028289,45351,4.2
2000,Sep,70.3,67.3,1078406,1031830,46576,4.3
2000,Oct,70.4,67.3,1083230,1035500,47730,4.4
2000,Nov,70.5,67.3,1088048,1039271,48777,4.5
2000,Dec,70.6,67.3,1092671,1042907,49764,4.6
2001,Jan,70.6,67.3,1096906,1046214,50692,4.6
2001,Feb,70.6,67.3,1100675,1049112,51563,4.7
2001,Mar,70.6,67.3,1103948,1051497,52451,4.8
2001,Apr,70.6,67.2,1106724,1053528,53196,4.8
2001,May,70.5,67.1,1109176,1055309,53867,4.9
2001,Jun,70.5,67,1111494,1056665,54829,4.9
2001,Jul,70.4,66.8,1113871,1057493,56378,5.1
2001,Aug,70.3,66.6,1116280,1057616,58664,5.3
2001,Sep,70.3,66.4,1118458,1056969,61489,5.5
2001,Oct,70.2,66.1,1120266,1055873,64393,5.7
2001,Nov,70.1,65.9,1121702,1054891,66811,6
2001,Dec,69.9,65.7,1122920,1054640,68280,6.1
2002,Jan,69.8,65.6,1124046,1055412,68634,6.1
2002,Feb,69.7,65.5,1125098,1057063,68035,6
2002,Mar,69.6,65.4,1126107,1059222,66885,5.9
2002,Apr,69.4,65.4,1127097,1061424,65673,5.8
2002,May,69.3,65.3,1128074,1063474,64600,5.7
2002,Jun,69.2,65.3,1129034,1065500,63534,5.6
2002,Jul,69,65.2,1129966,1067410,62556,5.5
2002,Aug,68.9,65.1,1130939,1069243,61696,5.5
2002,Sep,68.8,65.1,1132117,1071139,60978,5.4
2002,Oct,68.7,65,1133550,1073122,60428,5.3
2002,Nov,68.6,64.9,1135151,1075102,60049,5.3
2002,Dec,68.5,64.9,1136723,1076903,59820,5.3
2003,Jan,68.4,64.8,1138155,1078424,59731,5.2
2003,Feb,68.3,64.7,1139429,1079696,59733,5.2
2003,Mar,68.2,64.6,1140533,1080817,59716,5.2
2003,Apr,68.1,64.5,1141596,1081905,59691,5.2
2003,May,68,64.4,1142807,1083136,59671,5.2
2003,Jun,67.9,64.3,1144375,1084786,59589,5.2
2003,Jul,67.8,64.3,1146384,1087120,59264,5.2
2003,Aug,67.7,64.3,1148805,1090215,58590,5.1
2003,Sep,67.6,64.2,1151496,1093892,57604,5
2003,Oct,67.5,64.2,1154237,1097776,56461,4.9
2003,Nov,67.5,64.2,1156918,1101585,55333,4.8
2003,Dec,67.4,64.2,1159493,1105163,54330,4.7
2004,Jan,67.3,64.2,1161915,1108416,53499,4.6
2004,Feb,67.3,64.2,1164273,1111447,52826,4.5
2004,Mar,67.2,64.2,1166711,1114443,52268,4.5
2004,Apr,67.1,64.1,1169253,1117518,51735,4.4
2004,May,67,64.1,1171940,1120794,51146,4.4
2004,Jun,67,64.1,1174855,1124342,50513,4.3
2004,Jul,66.9,64.1,1178076,1128164,49912,4.2
2004,Aug,66.9,64.1,1181552,1132089,49463,4.2
2004,Sep,66.9,64.2,1185136,1135889,49247,4.2
2004,Oct,66.9,64.2,1188672,1139436,49236,4.1
2004,Nov,66.9,64.2,1192098,1142799,49299,4.1
2004,Dec,67,64.2,1195564,1146192,49372,4.1
2005,Jan,67,64.2,1199243,1149817,49426,4.1
2005,Feb,67,64.3,1203254,1153768,49486,4.1
2005,Mar,67.1,64.3,1207669,1158081,49588,4.1
2005,Apr,67.2,64.4,1212490,1162727,49763,4.1
2005,May,67.3,64.5,1217552,1167483,50069,4.1
2005,Jun,67.3,64.6,1222554,1172024,50530,4.1
2005,Jul,67.4,64.6,1227234,1176238,50996,4.2
2005,Aug,67.4,64.6,1231465,1180260,51205,4.2
2005,Sep,67.5,64.7,1235365,1184383,50982,4.1
2005,Oct,67.4,64.6,1239289,1188899,50390,4.1
2005,Nov,67.4,64.7,1243573,1193843,49730,4
2005,Dec,67.5,64.8,1248389,1199088,49301,3.9
2006,Jan,67.6,64.9,1253883,1204617,49266,3.9
2006,Feb,67.7,65,1259969,1210300,49669,3.9
2006,Mar,67.9,65.2,1266412,1215970,50442,4
2006,Apr,68,65.3,1272915,1221527,51388,4
2006,May,68.2,65.4,1279144,1226923,52221,4.1
2006,Jun,68.3,65.5,1284853,1232118,52735,4.1
2006,Jul,68.4,65.6,1290051,1237104,52947,4.1
2006,Aug,68.5,65.7,1294860,1241821,53039,4.1
2006,Sep,68.5,65.7,1299370,1246215,53155,4.1
2006,Oct,68.6,65.8,1303676,1250350,53326,4.1
2006,Nov,68.6,65.8,1307788,1254235,53553,4.1
2006,Dec,68.7,65.8,1311646,1257801,53845,4.1
2007,Jan,68.7,65.8,1315176,1260934,54242,4.1
2007,Feb,68.7,65.8,1318340,1263577,54763,4.2
2007,Mar,68.7,65.8,1321085,1265676,55409,4.2
2007,Apr,68.6,65.7,1323428,1267202,56226,4.2
2007,May,68.6,65.6,1325530,1268265,57265,4.3
2007,Jun,68.5,65.5,1327679,1269161,58518,4.4
2007,Jul,68.5,65.4,1330152,1270243,59909,4.5
2007,Aug,68.5,65.4,1333180,1271822,61358,4.6
2007,Sep,68.6,65.4,1336800,1273968,62832,4.7
2007,Oct,68.7,65.4,1340745,1276412,64333,4.8
2007,Nov,68.8,65.4,1344793,1278877,65916,4.9
2007,Dec,68.9,65.4,1348782,1281090,67692,5
2008,Jan,69,65.4,1352475,1282694,69781,5.2
2008,Feb,69,65.3,1355756,1283521,72235,5.3
2008,Mar,69.1,65.2,1358688,1283582,75106,5.5
2008,Apr,69.1,65.1,1361332,1282966,78366,5.8
2008,May,69.1,65,1363753,1281780,81973,6
2008,Jun,69.1,64.8,1365900,1279944,85956,6.3
2008,Jul,69.1,64.5,1367577,1277130,90447,6.6
2008,Aug,69.1,64.2,1368608,1272966,95642,7
2008,Sep,69,63.9,1368888,1267235,101653,7.4
2008,Oct,68.9,63.5,1368365,1259968,108397,7.9
2008,Nov,68.8,63,1366894,1251382,115512,8.5
2008,Dec,68.6,62.4,1364419,1241905,122514,9
2009,Jan,68.4,61.9,1361212,1232133,129079,9.5
2009,Feb,68.1,61.4,1357727,1222705,135022,9.9
2009,Mar,67.9,60.9,1354398,1214152,140246,10.4
2009,Apr,67.7,60.5,1351554,1206744,144810,10.7
2009,May,67.6,60.1,1349324,1200382,148942,11
2009,Jun,67.4,59.8,1347650,1194899,152751,11.3
2009,Jul,67.3,59.5,1346342,1190195,156147,11.6
2009,Aug,67.2,59.2,1345279,1186190,159089,11.8
2009,Sep,67.1,59,1344598,1182796,161802,12
2009,Oct,67,58.8,1344505,1179870,164635,12.2
2009,Nov,67,58.7,1345289,1177434,167855,12.5
2009,Dec,67.1,58.6,1347093,1175617,171476,12.7
2010,Jan,67.2,58.5,1349605,1174472,175133,13
2010,Feb,67.3,58.4,1352271,1173869,178402,13.2
2010,Mar,67.3,58.4,1354628,1173685,180943,13.4
2010,Apr,65.4,56.6,1356407,1173783,182624,13.5
2010,May,65.4,56.6,1357537,1174008,183529,13.5
2010,Jun,65.4,56.6,1358197,1174164,184033,13.5
2010,Jul,65.4,56.5,1358774,1174135,184639,13.6
2010,Aug,65.4,56.5,1359599,1174110,185489,13.6
2010,Sep,65.4,56.5,1360805,1174463,186342,13.7
2010,Oct,65.5,56.5,1362445,1175584,186861,13.7
2010,Nov,65.5,56.6,1364404,1177569,186835,13.7
2010,Dec,65.6,56.6,1366432,1180211,186221,13.6
2011,Jan,65.6,56.8,1368322,1183161,185161,13.5
2011,Feb,65.7,56.9,1369845,1185981,183864,13.4
2011,Mar,65.7,57,1370856,1188271,182585,13.3
2011,Apr,65.7,57,1371469,1189900,181569,13.2
2011,May,65.7,57,1371958,1191123,180835,13.2
2011,Jun,65.7,57.1,1372579,1192333,180246,13.1
2011,Jul,65.7,57.1,1373493,1193897,179596,13.1
2011,Aug,65.7,57.1,1374552,1195921,178631,13
2011,Sep,65.6,57.2,1375393,1198323,177070,12.9
2011,Oct,65.5,57.2,1375745,1200974,174771,12.7
2011,Nov,65.4,57.2,1375441,1203644,171797,12.5
2011,Dec,65.3,57.3,1374611,1206169,168442,12.3
2012,Jan,65.2,57.3,1373690,1208579,165111,12
2012,Feb,65.1,57.4,1373171,1210993,162178,11.8
2012,Mar,65,57.4,1373279,1213419,159860,11.6
2012,Apr,64.9,57.5,1373957,1215881,158076,11.5
2012,May,64.9,57.5,1375065,1218477,156588,11.4
2012,Jun,64.9,57.6,1376318,1221283,155035,11.3
2012,Jul,64.9,57.6,1377379,1224257,153122,11.1
2012,Aug,64.8,57.7,1378208,1227229,150979,11
2012,Sep,64.8,57.8,1378948,1229993,148955,10.8
2012,Oct,64.7,57.8,1379538,1232349,147189,10.7
2012,Nov,64.6,57.8,1379951,1234261,145690,10.6
2012,Dec,64.6,57.8,1380159,1235804,144355,10.5
2013,Jan,64.5,57.8,1379414,1236301,143113,10.4
2013,Feb,64.4,57.8,1379565,1237734,141831,10.3
2013,Mar,64.4,57.8,1379976,1239648,140328,10.2
2013,Apr,64.3,57.9,1380739,1242168,138571,10
2013,May,64.3,57.9,1381585,1244919,136666,9.9
2013,Jun,64.2,58,1382208,1247511,134697,9.7
2013,Jul,64.2,58,1382407,1249781,132626,9.6
2013,Aug,64.1,58,1382095,1251766,130329,9.4
2013,Sep,63.9,58,1381434,1253656,127778,9.2
2013,Oct,63.8,58,1381065,1255762,125303,9.1
2013,Nov,63.7,58.1,1381503,1258373,123130,8.9
2013,Dec,63.7,58.1,1382896,1261619,121277,8.8
2014,Jan,63.5,58,1379343,1260310,119033,8.6
2014,Feb,63.5,58.1,1381570,1264204,117366,8.5
2014,Mar,63.5,58.2,1383581,1267875,115706,8.4
2014,Apr,63.5,58.2,1385086,1271134,113952,8.2
2014,May,63.4,58.3,1386183,1274154,112029,8.1
2014,Jun,63.4,58.4,1387247,1277188,110059,7.9
2014,Jul,63.4,58.4,1388551,1280279,108272,7.8
2014,Aug,63.3,58.5,1390282,1283502,106780,7.7
2014,Sep,63.3,58.5,1392415,1286848,105567,7.6
2014,Oct,63.3,58.5,1394557,1290161,104396,7.5
2014,Nov,63.3,58.6,1396435,1293269,103166,7.4
2014,Dec,63.2,58.6,1398150,1296171,101979,7.3
2015,Jan,63.2,58.7,1399890,1299134,100756,7.2
2015,Feb,63.2,58.7,1401425,1301874,99551,7.1
2015,Mar,63.2,58.7,1402953,1304571,98382,7
2015,Apr,63.1,58.8,1404463,1307118,97345,6.9
2015,May,63.1,58.8,1405868,1309405,96463,6.9
2015,Jun,63,58.8,1407100,1311456,95644,6.8
2015,Jul,63,58.8,1408293,1313516,94777,6.7
2015,Aug,62.9,58.8,1409569,1315771,93798,6.7
2015,Sep,62.9,58.8,1410925,1318283,92642,6.6
2015,Oct,62.9,58.8,1412381,1321029,91352,6.5
2015,Nov,62.8,58.8,1413842,1323861,89981,6.4
2015,Dec,62.8,58.8,1415073,1326531,88542,6.3
2016,Jan,62.7,58.9,1416059,1328885,87174,6.2
2016,Feb,62.7,58.9,1416961,1331038,85923,6.1
2016,Mar,62.6,58.9,1418018,1333260,84758,6
2016,Apr,62.6,58.9,1419439,1335810,83629,5.9
2016,May,62.6,58.9,1421354,1338817,82537,5.8
2016,Jun,62.6,59,1423662,1342159,81503,5.7
2016,Jul,62.6,59,1426082,1345586,80496,5.6
2016,Aug,62.6,59.1,1428422,1348914,79508,5.6
2016,Sep,62.5,59.1,1430692,1352116,78576,5.5
2016,Oct,62.5,59.1,1432980,1355305,77675,5.4
2016,Nov,62.5,59.2,1435438,1358635,76803,5.4
2016,Dec,62.5,59.2,1438200,1362175,76025,5.3
2017,Jan,62.6,59.3,1441360,1365954,75406,5.2
2017,Feb,62.6,59.4,1444847,1369897,74950,5.2
2017,Mar,62.7,59.4,1448446,1373828,74618,5.2
2017,Apr,62.7,59.5,1452048,1377714,74334,5.1
2017,May,62.8,59.6,1455550,1381585,73965,5.1
2017,Jun,62.8,59.7,1458918,1385459,73459,5
2017,Jul,62.9,59.7,1462296,1389400,72896,5
2017,Aug,62.9,59.8,1465727,1393376,72351,4.9
2017,Sep,62.9,59.8,1469187,1397325,71862,4.9
2017,Oct,62.9,59.9,1472724,1401245,71479,4.9
2017,Nov,63,59.9,1476306,1405134,71172,4.8
2017,Dec,63,60,1479888,1409097,70791,4.8
2018,Jan,63.1,60.1,1483433,1413172,70261,4.7
2018,Feb,63.1,60.1,1486949,1417368,69581,4.7
2018,Mar,63.1,60.2,1490478,1421680,68798,4.6
2018,Apr,63.2,60.3,1493990,1425997,67993,4.6
2018,May,63.2,60.4,1497541,1430270,67271,4.5
2018,Jun,63.3,60.5,1501256,1434602,66654,4.4
2018,Jul,63.3,60.5,1505142,1439024,66118,4.4
2018,Aug,63.4,60.6,1509203,1443506,65697,4.4
2018,Sep,63.4,60.7,1513349,1447976,65373,4.3
2018,Oct,63.5,60.8,1517345,1452274,65071,4.3
2018,Nov,63.5,60.8,1521037,1456325,64712,4.3
2018,Dec,63.6,60.9,1524369,1460108,64261,4.2
2019,Jan,63.6,60.9,1527359,1463652,63707,4.2
2019,Feb,63.6,61,1530109,1467018,63091,4.1
2019,Mar,63.6,61,1532838,1470330,62508,4.1
2019,Apr,63.6,61.1,1535719,1473763,61956,4
2019,May,63.6,61.1,1538795,1477371,61424,4
2019,Jun,63.7,61.2,1542002,1481094,60908,3.9
2019,Jul,63.7,61.2,1545399,1485214,60185,3.9
2019,Aug,63.7,61.3,1548251,1489050,59201,3.8
2019,Sep,63.7,61.3,1550526,1492398,58128,3.7
2019,Oct,63.6,61.3,1551903,1494665,57238,3.7
2019,Nov,63.5,61.2,1551744,1494712,57032,3.7
2019,Dec,63.4,61.1,1551408,1494283,57125,3.7
2020,Jan,63.4,61.1,1555270,1498971,56299,3.6
2020,Feb,63.5,61.2,1559544,1503339,56205,3.6
2020,Mar,63.7,59.3,1566217,1458457,107760,6.9
2020,Apr,58,40.6,1429095,999349,429746,30.1
2020,May,56,41.9,1382809,1033264,349545,25.3
2020,Jun,60.7,51.5,1501064,1273638,227426,15.2
2020,Jul,60.1,51.6,1488599,1277858,210741,14.2
2020,Aug,60.3,52.3,1495350,1295922,199428,13.3
2020,Sep,61.2,53.5,1520357,1328650,191707,12.6
