Year,Period,labor force participation rate,employment-population ratio,labor force,employment,unemployment,unemployment rate
1976,Jan,58.3,52.3,7687165,6896554,790611,10.3
1976,Feb,58.2,52.2,7684752,6895390,789362,10.3
1976,Mar,58.2,52.2,7684481,6897998,786483,10.2
1976,Apr,58.2,52.3,7689935,6906874,783061,10.2
1976,May,58.2,52.3,7699911,6917563,782348,10.2
1976,Jun,58.3,52.4,7710197,6926350,783847,10.2
1976,Jul,58.3,52.4,7714711,6928065,786646,10.2
1976,Aug,58.3,52.3,7711955,6922698,789257,10.2
1976,Sep,58.2,52.2,7702135,6912814,789321,10.2
1976,Oct,58.1,52.2,7688549,6901865,786684,10.2
1976,Nov,58,52.1,7675643,6894001,781642,10.2
1976,Dec,57.9,52.1,7669179,6893647,775532,10.1
1977,Jan,58,52.2,7673859,6903917,769942,10
1977,Feb,58.1,52.3,7685946,6923761,762185,9.9
1977,Mar,58.1,52.5,7699013,6948749,750264,9.7
1977,Apr,58.2,52.7,7710663,6975580,735083,9.5
1977,May,58.3,52.9,7719926,7001075,718851,9.3
1977,Jun,58.3,53,7726901,7022585,704316,9.1
1977,Jul,58.4,53.2,7733588,7040877,692711,9
1977,Aug,58.5,53.3,7742645,7058488,684157,8.8
1977,Sep,58.5,53.4,7754068,7076707,677361,8.7
1977,Oct,58.6,53.6,7765621,7095195,670426,8.6
1977,Nov,58.7,53.7,7775641,7113136,662505,8.5
1977,Dec,58.7,53.8,7782581,7128771,653810,8.4
1978,Jan,58.8,53.9,7787320,7143545,643775,8.3
1978,Feb,58.8,54,7792592,7158808,633784,8.1
1978,Mar,58.9,54.2,7799865,7174491,625374,8
1978,Apr,58.9,54.3,7808695,7189887,618808,7.9
1978,May,59,54.4,7819734,7205741,613993,7.9
1978,Jun,59.1,54.5,7832827,7223321,609506,7.8
1978,Jul,59.2,54.7,7847213,7242277,604936,7.7
1978,Aug,59.3,54.8,7862942,7262302,600640,7.6
1978,Sep,59.5,55,7880750,7284730,596020,7.6
1978,Oct,59.6,55.1,7901898,7310842,591056,7.5
1978,Nov,59.8,55.3,7924783,7338896,585887,7.4
1978,Dec,59.9,55.5,7944266,7363972,580294,7.3
1979,Jan,60,55.6,7955684,7381316,574368,7.2
1979,Feb,60,55.7,7959763,7391227,568536,7.1
1979,Mar,60,55.7,7960601,7396959,563642,7.1
1979,Apr,60,55.8,7962758,7401466,561292,7
1979,May,60,55.8,7970035,7407580,562455,7.1
1979,Jun,60.1,55.8,7982659,7415310,567349,7.1
1979,Jul,60.2,55.9,7999247,7425317,573930,7.2
1979,Aug,60.4,56,8017455,7437082,580373,7.2
1979,Sep,60.5,56.1,8034013,7448242,585771,7.3
1979,Oct,60.5,56.1,8044467,7456960,587507,7.3
1979,Nov,60.6,56.2,8046086,7461673,584413,7.3
1979,Dec,60.5,56.1,8040294,7460829,579465,7.2
1980,Jan,60.4,56.1,8028702,7452203,576499,7.2
1980,Feb,60.3,55.9,8012458,7434606,577852,7.2
1980,Mar,60.1,55.7,7993688,7409844,583844,7.3
1980,Apr,60,55.5,7975051,7382931,592120,7.4
1980,May,59.8,55.3,7959384,7359185,600199,7.5
1980,Jun,59.7,55.2,7950541,7344270,606271,7.6
1980,Jul,59.7,55.1,7948491,7339732,608759,7.7
1980,Aug,59.7,55.1,7950512,7343684,606828,7.6
1980,Sep,59.7,55.2,7955340,7352626,602714,7.6
1980,Oct,59.7,55.2,7963137,7362102,601035,7.5
1980,Nov,59.8,55.3,7975839,7372157,603682,7.6
1980,Dec,59.9,55.3,7995685,7386605,609080,7.6
1981,Jan,60.1,55.5,8021001,7405176,615825,7.7
1981,Feb,60.2,55.6,8046249,7424294,621955,7.7
1981,Mar,60.3,55.7,8065538,7441190,624348,7.7
1981,Apr,60.4,55.7,8073028,7451699,621329,7.7
1981,May,60.3,55.7,8065869,7452784,613085,7.6
1981,Jun,60.1,55.6,8047169,7445355,601814,7.5
1981,Jul,59.9,55.5,8023540,7431197,592343,7.4
1981,Aug,59.7,55.3,8001955,7413239,588716,7.4
1981,Sep,59.6,55.2,7986251,7395151,591100,7.4
1981,Oct,59.5,55,7978150,7379824,598326,7.5
1981,Nov,59.4,54.9,7975144,7365850,609294,7.6
1981,Dec,59.4,54.8,7974771,7352769,622002,7.8
1982,Jan,59.4,54.7,7976631,7343565,633066,7.9
1982,Feb,59.4,54.6,7980422,7339090,641332,8
1982,Mar,59.4,54.6,7984128,7336760,647368,8.1
1982,Apr,59.4,54.5,7987010,7334993,652017,8.2
1982,May,59.4,54.5,7988116,7331849,656267,8.2
1982,Jun,59.3,54.4,7985785,7324164,661621,8.3
1982,Jul,59.3,54.3,7980868,7311302,669566,8.4
1982,Aug,59.2,54.1,7975605,7294904,680701,8.5
1982,Sep,59.1,54,7972315,7277046,695269,8.7
1982,Oct,59.1,53.8,7971774,7260021,711753,8.9
1982,Nov,59.1,53.7,7973878,7247062,726816,9.1
1982,Dec,59.1,53.6,7975272,7238089,737183,9.2
1983,Jan,59,53.5,7975079,7232729,742350,9.3
1983,Feb,59,53.5,7976511,7234185,742326,9.3
1983,Mar,59,53.6,7982910,7244713,738197,9.2
1983,Apr,59.1,53.7,7997761,7265240,732521,9.2
1983,May,59.2,53.9,8019832,7293924,725908,9.1
1983,Jun,59.4,54.1,8044373,7327161,717212,8.9
1983,Jul,59.5,54.3,8066458,7361277,705181,8.7
1983,Aug,59.6,54.5,8080773,7390869,689904,8.5
1983,Sep,59.6,54.6,8084502,7412353,672149,8.3
1983,Oct,59.5,54.7,8078782,7425886,652896,8.1
1983,Nov,59.4,54.7,8067726,7433476,634250,7.9
1983,Dec,59.3,54.8,8057585,7439623,617962,7.7
1984,Jan,59.2,54.8,8053218,7449882,603336,7.5
1984,Feb,59.2,54.9,8056637,7466024,590613,7.3
1984,Mar,59.3,55,8068225,7486063,582162,7.2
1984,Apr,59.4,55.1,8084388,7505941,578447,7.2
1984,May,59.5,55.2,8102352,7522726,579626,7.2
1984,Jun,59.6,55.3,8118126,7534320,583806,7.2
1984,Jul,59.6,55.3,8127075,7540016,587059,7.2
1984,Aug,59.6,55.3,8129770,7542633,587137,7.2
1984,Sep,59.6,55.3,8129062,7545795,583267,7.2
1984,Oct,59.6,55.3,8128824,7553219,575605,7.1
1984,Nov,59.6,55.4,8133760,7567724,566036,7
1984,Dec,59.6,55.6,8145936,7588255,557681,6.8
1985,Jan,59.7,55.7,8162398,7608817,553581,6.8
1985,Feb,59.8,55.8,8177031,7623263,553768,6.8
1985,Mar,59.9,55.8,8184560,7629801,554759,6.8
1985,Apr,60.3,56.3,8249355,7695257,554098,6.7
1985,May,60.5,56.5,8278164,7726502,551662,6.7
1985,Jun,60.6,56.6,8293359,7745005,548354,6.6
1985,Jul,60.7,56.7,8307718,7761951,545767,6.6
1985,Aug,60.8,56.9,8325905,7783043,542862,6.5
1985,Sep,61,57,8347996,7808417,539579,6.5
1985,Oct,61.1,57.2,8371636,7833604,538032,6.4
1985,Nov,61.3,57.3,8392584,7853542,539042,6.4
1985,Dec,61.4,57.4,8407813,7865100,542713,6.5
1986,Jan,61.4,57.4,8417695,7869249,548446,6.5
1986,Feb,61.5,57.4,8425409,7870640,554769,6.6
1986,Mar,61.5,57.4,8432690,7873009,559681,6.6
1986,Apr,61.6,57.5,8439440,7878431,561009,6.6
1986,May,61.6,57.5,8444060,7887486,556574,6.6
1986,Jun,61.6,57.6,8446309,7899992,546317,6.5
1986,Jul,61.6,57.7,8446807,7914993,531814,6.3
1986,Aug,61.6,57.8,8446010,7929866,516144,6.1
1986,Sep,61.5,57.9,8444650,7942965,501685,5.9
1986,Oct,61.5,57.9,8443246,7954497,488749,5.8
1986,Nov,61.5,58,8441569,7964163,477406,5.7
1986,Dec,61.4,58,8440883,7974393,466490,5.5
1987,Jan,61.4,58.1,8441771,7986560,455211,5.4
1987,Feb,61.4,58.2,8443503,7999842,443661,5.3
1987,Mar,61.4,58.3,8447195,8014696,432499,5.1
1987,Apr,61.5,58.4,8453220,8031202,422018,5
1987,May,61.5,58.5,8461149,8048381,412768,4.9
1987,Jun,61.5,58.6,8471192,8064923,406269,4.8
1987,Jul,61.6,58.7,8483495,8080162,403333,4.8
1987,Aug,61.7,58.8,8497287,8094174,403113,4.7
1987,Sep,61.8,58.9,8510594,8107825,402769,4.7
1987,Oct,61.8,58.9,8520595,8120516,400079,4.7
1987,Nov,61.9,59,8525703,8132516,393187,4.6
1987,Dec,61.8,59.1,8524333,8142148,382185,4.5
1988,Jan,61.8,59.1,8516679,8148513,368166,4.3
1988,Feb,61.7,59.1,8506600,8152981,353619,4.2
1988,Mar,61.6,59.1,8498645,8156087,342558,4
1988,Apr,61.6,59.1,8497368,8158999,338369,4
1988,May,61.6,59.1,8505117,8163322,341795,4
1988,Jun,61.7,59.2,8520534,8170127,350407,4.1
1988,Jul,61.8,59.2,8540340,8179165,361175,4.2
1988,Aug,62,59.3,8561839,8189447,372392,4.3
1988,Sep,62.2,59.4,8583153,8199978,383175,4.5
1988,Oct,62.3,59.5,8602025,8210585,391440,4.6
1988,Nov,62.4,59.5,8617868,8220962,396906,4.6
1988,Dec,62.5,59.6,8631431,8230468,400963,4.6
1989,Jan,62.6,59.7,8644324,8239246,405078,4.7
1989,Feb,62.7,59.7,8656545,8246117,410428,4.7
1989,Mar,62.8,59.8,8667962,8251902,416060,4.8
1989,Apr,62.9,59.8,8677599,8256538,421061,4.9
1989,May,62.9,59.8,8684836,8259412,425424,4.9
1989,Jun,63,59.8,8690808,8260707,430101,4.9
1989,Jul,63,59.8,8696915,8261118,435797,5
1989,Aug,63.1,59.9,8704437,8262776,441661,5.1
1989,Sep,63.1,59.9,8715162,8268108,447054,5.1
1989,Oct,63.2,60,8731611,8279526,452085,5.2
1989,Nov,63.4,60.1,8752551,8296356,456195,5.2
1989,Dec,63.6,60.2,8775180,8316742,458438,5.2
1990,Jan,62.7,59.5,8796154,8338055,458099,5.2
1990,Feb,62.8,59.5,8812167,8357217,454950,5.2
1990,Mar,62.8,59.6,8821532,8370923,450609,5.1
1990,Apr,62.8,59.6,8824908,8377690,447218,5.1
1990,May,62.7,59.5,8825081,8378472,446609,5.1
1990,Jun,62.6,59.4,8823069,8373371,449698,5.1
1990,Jul,62.6,59.3,8820754,8364181,456573,5.2
1990,Aug,62.5,59.2,8818372,8351164,467208,5.3
1990,Sep,62.5,59.1,8813305,8332587,480718,5.5
1990,Oct,62.4,58.9,8804304,8307610,496694,5.6
1990,Nov,62.3,58.7,8793744,8278987,514757,5.9
1990,Dec,62.3,58.5,8784321,8249326,534995,6.1
1991,Jan,62.2,58.3,8777929,8219779,558150,6.4
1991,Feb,62.2,58.1,8775940,8192963,582977,6.6
1991,Mar,62.3,57.9,8775539,8169223,606316,6.9
1991,Apr,62.2,57.8,8773441,8148418,625023,7.1
1991,May,62.2,57.7,8767616,8130636,636980,7.3
1991,Jun,62.1,57.6,8757553,8115530,642023,7.3
1991,Jul,62,57.5,8743327,8100769,642558,7.3
1991,Aug,61.9,57.3,8727816,8084980,642836,7.4
1991,Sep,61.8,57.2,8715680,8068393,647287,7.4
1991,Oct,61.7,57.1,8708582,8050294,658288,7.6
1991,Nov,61.7,56.9,8705941,8031299,674642,7.7
1991,Dec,61.7,56.8,8706137,8013353,692784,8
1992,Jan,61.7,56.7,8708926,7999171,709755,8.1
1992,Feb,61.8,56.6,8714912,7990052,724860,8.3
1992,Mar,61.9,56.6,8725365,7987568,737797,8.5
1992,Apr,62,56.6,8740047,7990891,749156,8.6
1992,May,62.1,56.7,8754894,7995743,759151,8.7
1992,Jun,62.1,56.7,8766480,7999215,767265,8.8
1992,Jul,62.2,56.7,8773818,8001004,772814,8.8
1992,Aug,62.2,56.7,8776018,8001319,774699,8.8
1992,Sep,62.1,56.6,8772947,8000418,772529,8.8
1992,Oct,62,56.6,8766374,8000168,766206,8.7
1992,Nov,62,56.6,8756812,8000282,756530,8.6
1992,Dec,61.9,56.6,8745286,8000812,744474,8.5
1993,Jan,61.8,56.6,8733683,8003049,730634,8.4
1993,Feb,61.7,56.6,8723152,8007237,715915,8.2
1993,Mar,61.6,56.7,8715644,8013517,702127,8.1
1993,Apr,61.6,56.7,8711654,8021349,690305,7.9
1993,May,61.6,56.7,8711124,8029031,682093,7.8
1993,Jun,61.6,56.8,8713337,8034630,678707,7.8
1993,Jul,61.5,56.8,8715058,8036330,678728,7.8
1993,Aug,61.5,56.7,8715040,8035066,679974,7.8
1993,Sep,61.5,56.7,8714887,8034395,680492,7.8
1993,Oct,61.5,56.7,8715671,8035928,679743,7.8
1993,Nov,61.5,56.7,8718020,8039549,678471,7.8
1993,Dec,61.5,56.8,8721201,8045541,675660,7.7
1994,Jan,61.5,56.8,8721845,8052421,669424,7.7
1994,Feb,61.5,56.9,8716537,8057256,659281,7.6
1994,Mar,61.4,56.9,8704544,8057843,646701,7.4
1994,Apr,61.3,56.8,8688016,8054927,633089,7.3
1994,May,61.2,56.8,8671546,8052095,619451,7.1
1994,Jun,61.1,56.8,8659424,8052845,606579,7
1994,Jul,61.1,56.9,8654246,8059480,594766,6.9
1994,Aug,61,56.9,8654979,8071359,583620,6.7
1994,Sep,61.1,57,8658712,8086242,572470,6.6
1994,Oct,61.1,57.1,8662816,8102511,560305,6.5
1994,Nov,61.1,57.2,8666851,8118839,548012,6.3
1994,Dec,61.1,57.3,8669405,8130782,538623,6.2
1995,Jan,61.1,57.3,8668788,8134523,534265,6.2
1995,Feb,61.1,57.3,8665605,8131282,534323,6.2
1995,Mar,61.1,57.3,8661084,8123523,537561,6.2
1995,Apr,61,57.2,8656628,8113625,543003,6.3
1995,May,61,57.1,8654154,8105053,549101,6.3
1995,Jun,61,57.1,8654069,8100273,553796,6.4
1995,Jul,61,57.1,8656212,8099536,556676,6.4
1995,Aug,61,57.1,8659665,8101908,557757,6.4
1995,Sep,61,57.1,8662646,8106073,556573,6.4
1995,Oct,61,57.1,8664429,8110815,553614,6.4
1995,Nov,61,57.1,8665220,8115847,549373,6.3
1995,Dec,61,57.1,8667829,8122020,545809,6.3
1996,Jan,61,57.2,8676288,8131307,544981,6.3
1996,Feb,61.1,57.3,8692038,8144391,547647,6.3
1996,Mar,61.3,57.4,8713366,8161184,552182,6.3
1996,Apr,61.4,57.5,8736676,8181321,555355,6.4
1996,May,61.6,57.7,8758880,8204109,554771,6.3
1996,Jun,61.7,57.8,8779097,8228714,550383,6.3
1996,Jul,61.8,58,8798180,8254302,543878,6.2
1996,Aug,61.9,58.1,8817324,8278693,538631,6.1
1996,Sep,62,58.2,8836157,8297868,538289,6.1
1996,Oct,62.1,58.3,8854420,8310147,544273,6.1
1996,Nov,62.2,58.3,8872559,8317522,555037,6.3
1996,Dec,62.3,58.3,8891400,8324338,567062,6.4
1997,Jan,62.4,58.4,8911659,8333905,577754,6.5
1997,Feb,62.6,58.5,8933963,8348269,585694,6.6
1997,Mar,62.8,58.6,8958859,8368885,589974,6.6
1997,Apr,63,58.8,8986277,8394265,592012,6.6
1997,May,63.1,59,9012356,8419436,592920,6.6
1997,Jun,63.2,59.1,9033067,8440764,592303,6.6
1997,Jul,63.3,59.2,9046902,8457735,589167,6.5
1997,Aug,63.3,59.2,9054149,8470816,583333,6.4
1997,Sep,63.3,59.3,9056630,8481537,575093,6.3
1997,Oct,63.2,59.3,9056832,8490506,566326,6.3
1997,Nov,63.2,59.3,9055815,8497555,558260,6.2
1997,Dec,63.2,59.3,9054800,8503839,550961,6.1
1998,Jan,63.1,59.3,9054056,8510512,543544,6
1998,Feb,63.1,59.4,9053560,8518256,535304,5.9
1998,Mar,63.1,59.4,9052610,8526423,526187,5.8
1998,Apr,63,59.4,9052004,8535778,516226,5.7
1998,May,63,59.5,9053944,8547055,506889,5.6
1998,Jun,63,59.5,9059204,8558956,500248,5.5
1998,Jul,63,59.6,9067021,8569737,497284,5.5
1998,Aug,63.1,59.6,9077075,8580366,496709,5.5
1998,Sep,63.1,59.6,9088861,8591786,497075,5.5
1998,Oct,63.1,59.7,9099746,8603458,496288,5.5
1998,Nov,63.1,59.7,9107113,8613449,493664,5.4
1998,Dec,63.1,59.7,9109717,8620015,489702,5.4
1999,Jan,63.1,59.7,9108381,8623485,484896,5.3
1999,Feb,63.1,59.7,9106298,8625245,481053,5.3
1999,Mar,63,59.7,9106566,8627336,479230,5.3
1999,Apr,63,59.7,9110450,8630814,479636,5.3
1999,May,63.1,59.7,9117406,8636073,481333,5.3
1999,Jun,63.1,59.7,9126613,8643942,482671,5.3
1999,Jul,63.1,59.8,9135573,8653680,481893,5.3
1999,Aug,63.1,59.8,9141542,8663902,477640,5.2
1999,Sep,63.1,59.9,9143518,8674050,469468,5.1
1999,Oct,63.1,59.9,9142895,8684233,458662,5
1999,Nov,63,59.9,9142965,8695676,447289,4.9
1999,Dec,63,60,9145142,8707653,437489,4.8
2000,Jan,63,60,9148772,8718077,430695,4.7
2000,Feb,63,60.1,9150933,8724877,426056,4.7
2000,Mar,63,60.1,9149949,8726607,423342,4.6
2000,Apr,63,60.1,9145145,8723092,422053,4.6
2000,May,62.9,60,9136838,8716038,420800,4.6
2000,Jun,62.8,59.9,9126545,8707347,419198,4.6
2000,Jul,62.7,59.8,9117373,8700292,417081,4.6
2000,Aug,62.6,59.8,9113416,8699324,414092,4.5
2000,Sep,62.6,59.8,9116092,8706475,409617,4.5
2000,Oct,62.6,59.8,9124683,8721464,403219,4.4
2000,Nov,62.6,59.9,9135828,8740180,395648,4.3
2000,Dec,62.7,60,9145125,8756838,388287,4.2
2001,Jan,62.7,60.1,9149403,8766694,382709,4.2
2001,Feb,62.6,60,9148011,8767790,380221,4.2
2001,Mar,62.6,60,9141552,8760193,381359,4.2
2001,Apr,62.5,59.8,9132763,8745968,386795,4.2
2001,May,62.4,59.7,9126617,8729233,397384,4.4
2001,Jun,62.3,59.5,9125876,8712890,412986,4.5
2001,Jul,62.4,59.4,9132095,8699049,433046,4.7
2001,Aug,62.4,59.3,9142544,8685756,456788,5
2001,Sep,62.4,59.1,9154926,8672427,482499,5.3
2001,Oct,62.5,59,9168482,8660555,507927,5.5
2001,Nov,62.5,58.9,9182280,8651335,530945,5.8
2001,Dec,62.6,58.9,9197679,8647591,550088,6
2002,Jan,62.7,58.9,9215047,8650499,564548,6.1
2002,Feb,62.8,58.9,9232774,8658481,574293,6.2
2002,Mar,62.9,59,9249119,8669535,579584,6.3
2002,Apr,63,59,9263603,8683503,580100,6.3
2002,May,63,59.1,9275952,8699645,576307,6.2
2002,Jun,63.1,59.2,9286050,8716472,569578,6.1
2002,Jul,63.1,59.2,9292936,8730281,562655,6.1
2002,Aug,63.1,59.3,9297709,8739159,558550,6
2002,Sep,63,59.2,9301647,8742256,559391,6
2002,Oct,63,59.2,9303119,8738599,564520,6.1
2002,Nov,63,59.1,9302259,8730762,571497,6.1
2002,Dec,62.9,59,9298512,8720863,577649,6.2
2003,Jan,62.8,58.9,9293854,8711662,582192,6.3
2003,Feb,62.8,58.8,9290354,8705298,585056,6.3
2003,Mar,62.8,58.8,9286833,8700335,586498,6.3
2003,Apr,62.7,58.7,9280666,8692684,587982,6.3
2003,May,62.6,58.6,9270558,8679734,590824,6.4
2003,Jun,62.5,58.5,9259338,8664420,594918,6.4
2003,Jul,62.4,58.3,9249134,8651128,598006,6.5
2003,Aug,62.3,58.2,9241539,8642814,598725,6.5
2003,Sep,62.2,58.2,9238227,8641565,596662,6.5
2003,Oct,62.2,58.2,9241024,8647113,593911,6.4
2003,Nov,62.2,58.2,9249302,8656815,592487,6.4
2003,Dec,62.2,58.3,9258922,8667235,591687,6.4
2004,Jan,62.3,58.3,9265169,8675101,590068,6.4
2004,Feb,62.3,58.3,9266727,8680024,586703,6.3
2004,Mar,62.5,58.5,9300272,8718791,581481,6.3
2004,Apr,62.6,58.8,9326798,8753347,573451,6.1
2004,May,62.7,58.9,9347739,8785278,562461,6
2004,Jun,62.8,59.1,9363865,8814864,549001,5.9
2004,Jul,62.8,59.2,9377242,8841888,535354,5.7
2004,Aug,62.9,59.4,9388436,8865420,523016,5.6
2004,Sep,62.9,59.5,9396011,8883320,512691,5.5
2004,Oct,62.9,59.5,9398541,8894802,503739,5.4
2004,Nov,62.8,59.5,9396294,8901578,494716,5.3
2004,Dec,62.8,59.5,9394413,8907475,486938,5.2
2005,Jan,62.8,59.6,9396085,8915505,480580,5.1
2005,Feb,62.8,59.6,9401262,8925944,475318,5.1
2005,Mar,62.8,59.7,9409839,8939247,470592,5
2005,Apr,62.9,59.8,9423325,8956211,467114,5
2005,May,63,59.9,9442291,8976408,465883,4.9
2005,Jun,63.1,60,9463924,8995850,468074,4.9
2005,Jul,63.2,60,9483995,9010415,473580,5
2005,Aug,63.3,60.1,9498246,9019218,479028,5
2005,Sep,63.3,60.1,9505190,9023777,481413,5.1
2005,Oct,63.2,60,9506360,9027025,479335,5
2005,Nov,63.1,60,9504409,9030508,473901,5
2005,Dec,63.1,60,9500990,9034673,466317,4.9
2006,Jan,63,60,9499541,9041288,458253,4.8
2006,Feb,63,60,9502227,9050364,451863,4.8
2006,Mar,63.1,60.1,9508146,9059283,448863,4.7
2006,Apr,63.1,60.1,9513981,9065340,448641,4.7
2006,May,63.1,60.1,9516161,9068445,447716,4.7
2006,Jun,63,60.1,9513249,9069599,443650,4.7
2006,Jul,63,60.1,9507535,9072177,435358,4.6
2006,Aug,62.9,60.1,9503367,9077822,425545,4.5
2006,Sep,62.9,60.1,9503147,9086018,417129,4.4
2006,Oct,62.9,60.1,9507130,9096735,410395,4.3
2006,Nov,62.9,60.2,9513238,9107686,405552,4.3
2006,Dec,62.9,60.2,9517371,9114514,402857,4.2
2007,Jan,62.8,60.2,9517017,9114266,402751,4.2
2007,Feb,62.8,60.1,9513343,9107919,405424,4.3
2007,Mar,62.7,60,9507329,9097197,410132,4.3
2007,Apr,62.6,59.9,9501517,9085144,416373,4.4
2007,May,62.6,59.8,9498541,9074455,424086,4.5
2007,Jun,62.5,59.7,9499555,9067526,432029,4.5
2007,Jul,62.5,59.7,9504776,9065612,439164,4.6
2007,Aug,62.6,59.7,9514662,9069298,445364,4.7
2007,Sep,62.6,59.7,9528946,9078967,449979,4.7
2007,Oct,62.7,59.7,9545835,9091815,454020,4.8
2007,Nov,62.8,59.8,9563786,9106286,457500,4.8
2007,Dec,62.9,59.9,9581991,9121473,460518,4.8
2008,Jan,63,59.9,9598042,9134103,463939,4.8
2008,Feb,63,60,9610400,9142919,467481,4.9
2008,Mar,63.1,60,9620542,9148598,471944,4.9
2008,Apr,63.1,60,9630522,9151583,478939,5
2008,May,63.2,60,9642282,9153029,489253,5.1
2008,Jun,63.3,60,9657335,9154693,502642,5.2
2008,Jul,63.3,60,9674584,9156275,518309,5.4
2008,Aug,63.4,59.9,9691204,9155607,535597,5.5
2008,Sep,63.5,59.8,9704706,9148655,556051,5.7
2008,Oct,63.5,59.7,9713684,9131699,581985,6
2008,Nov,63.5,59.5,9716531,9102543,613988,6.3
2008,Dec,63.4,59.2,9712772,9062274,650498,6.7
2009,Jan,63.3,58.8,9703544,9014776,688768,7.1
2009,Feb,63.2,58.5,9692579,8966570,726009,7.5
2009,Mar,63.2,58.2,9684568,8926228,758340,7.8
2009,Apr,63.1,58,9680939,8897835,783104,8.1
2009,May,63.1,57.9,9678652,8877362,801290,8.3
2009,Jun,63,57.7,9674374,8859328,815046,8.4
2009,Jul,62.9,57.6,9664397,8838266,826131,8.5
2009,Aug,62.8,57.4,9646808,8811462,835346,8.7
2009,Sep,62.6,57.1,9624047,8781638,842409,8.8
2009,Oct,62.4,56.9,9599817,8753163,846654,8.8
2009,Nov,62.3,56.8,9582339,8733084,849255,8.9
2009,Dec,62.2,56.7,9578723,8727519,851204,8.9
2010,Jan,62.3,56.7,9589044,8737735,851309,8.9
2010,Feb,62.4,56.9,9605948,8757142,848806,8.8
2010,Mar,62.4,57,9621227,8776986,844241,8.8
2010,Apr,62.8,57.3,9630479,8792421,838058,8.7
2010,May,62.8,57.4,9631529,8801543,829986,8.6
2010,Jun,62.7,57.3,9623572,8801658,821914,8.5
2010,Jul,62.6,57.2,9609354,8792951,816403,8.5
2010,Aug,62.4,57.1,9593332,8779428,813904,8.5
2010,Sep,62.2,57,9577587,8764345,813242,8.5
2010,Oct,62.1,56.8,9563891,8752287,811604,8.5
2010,Nov,62,56.8,9551431,8744834,806597,8.4
2010,Dec,61.9,56.7,9539098,8740995,798103,8.4
2011,Jan,61.8,56.7,9528314,8739920,788394,8.3
2011,Feb,61.7,56.6,9517986,8738380,779606,8.2
2011,Mar,61.6,56.6,9506231,8733288,772943,8.1
2011,Apr,61.4,56.5,9493559,8723458,770101,8.1
2011,May,61.3,56.3,9483635,8711503,772132,8.1
2011,Jun,61.3,56.3,9480227,8702587,777640,8.2
2011,Jul,61.3,56.2,9486165,8701473,784692,8.3
2011,Aug,61.3,56.2,9500945,8708594,792351,8.3
2011,Sep,61.4,56.3,9521336,8721554,799782,8.4
2011,Oct,61.6,56.3,9543711,8736516,807195,8.5
2011,Nov,61.6,56.4,9562510,8748504,814006,8.5
2011,Dec,61.7,56.4,9574444,8754959,819485,8.6
2012,Jan,61.7,56.4,9581121,8757122,823999,8.6
2012,Feb,61.7,56.4,9586612,8758084,828528,8.6
2012,Mar,61.7,56.4,9591657,8757816,833841,8.7
2012,Apr,61.7,56.3,9594584,8756373,838211,8.7
2012,May,61.7,56.3,9597583,8757979,839604,8.7
2012,Jun,61.7,56.3,9602266,8765976,836290,8.7
2012,Jul,61.7,56.4,9608455,8780838,827617,8.6
2012,Aug,61.8,56.5,9617913,8801370,816543,8.5
2012,Sep,61.8,56.6,9631758,8824815,806943,8.4
2012,Oct,61.9,56.7,9645555,8845696,799859,8.3
2012,Nov,61.9,56.8,9655584,8860603,794981,8.2
2012,Dec,61.9,56.8,9659771,8868947,790824,8.2
2013,Jan,61.9,56.8,9655271,8869350,785921,8.1
2013,Feb,61.8,56.8,9651505,8872227,779278,8.1
2013,Mar,61.8,56.9,9651758,8880955,770803,8
2013,Apr,61.8,57,9660078,8897969,762109,7.9
2013,May,61.9,57.1,9672985,8917413,755572,7.8
2013,Jun,61.9,57.1,9685182,8932756,752426,7.8
2013,Jul,62,57.2,9692150,8941331,750819,7.7
2013,Aug,61.9,57.2,9687837,8942726,745111,7.7
2013,Sep,61.8,57.1,9671445,8938974,732471,7.6
2013,Oct,61.6,57.1,9650536,8934550,715986,7.4
2013,Nov,61.5,57,9631855,8933068,698787,7.3
2013,Dec,61.4,57,9617388,8934768,682620,7.1
2014,Jan,61,56.7,9557444,8891979,665465,7
2014,Feb,60.9,56.8,9548508,8896686,651822,6.8
2014,Mar,60.9,56.8,9540438,8900374,640064,6.7
2014,Apr,60.8,56.8,9531103,8901572,629531,6.6
2014,May,60.7,56.8,9521124,8903144,617980,6.5
2014,Jun,60.7,56.8,9514317,8909035,605282,6.4
2014,Jul,60.6,56.8,9511481,8918415,593066,6.2
2014,Aug,60.6,56.9,9514182,8931022,583160,6.1
2014,Sep,60.6,57,9521660,8946039,575621,6
2014,Oct,60.7,57.1,9529358,8961204,568154,6
2014,Nov,60.7,57.1,9534612,8974604,560008,5.9
2014,Dec,60.7,57.2,9540144,8987189,552955,5.8
2015,Jan,60.8,57.3,9544579,8997585,546994,5.7
2015,Feb,60.8,57.4,9552949,9010168,542781,5.7
2015,Mar,60.9,57.4,9561497,9023616,537881,5.6
2015,Apr,60.9,57.5,9568011,9037463,530548,5.5
2015,May,60.9,57.6,9569402,9049193,520209,5.4
2015,Jun,60.9,57.6,9563755,9056618,507137,5.3
2015,Jul,60.8,57.7,9554722,9061246,493476,5.2
2015,Aug,60.7,57.7,9547385,9065479,481906,5
2015,Sep,60.7,57.7,9545316,9072213,473103,5
2015,Oct,60.8,57.8,9552323,9084409,467914,4.9
2015,Nov,60.8,57.9,9567364,9100847,466517,4.9
2015,Dec,60.9,58,9582950,9116556,466394,4.9
2016,Jan,61,58,9591743,9126494,465249,4.9
2016,Feb,61,58,9590442,9127609,462833,4.8
2016,Mar,60.9,58,9579507,9119809,459698,4.8
2016,Apr,60.8,57.9,9564084,9106300,457784,4.8
2016,May,60.7,57.8,9550935,9091949,458986,4.8
2016,Jun,60.7,57.7,9543083,9080187,462896,4.9
2016,Jul,60.7,57.7,9539996,9072562,467434,4.9
2016,Aug,60.6,57.7,9539455,9068476,470979,4.9
2016,Sep,60.6,57.6,9539105,9066158,472947,5
2016,Oct,60.6,57.6,9536267,9064636,471631,4.9
2016,Nov,60.6,57.6,9531775,9065980,465795,4.9
2016,Dec,60.6,57.7,9529163,9071509,457654,4.8
2017,Jan,60.6,57.7,9530913,9080374,450539,4.7
2017,Feb,60.7,57.8,9537224,9091221,446003,4.7
2017,Mar,60.7,57.9,9545838,9100810,445028,4.7
2017,Apr,60.8,57.9,9555504,9108274,447230,4.7
2017,May,60.9,58,9564471,9113926,450545,4.7
2017,Jun,60.9,58,9570659,9117029,453630,4.7
2017,Jul,60.9,58,9572659,9117049,455610,4.8
2017,Aug,60.9,58,9568287,9113232,455055,4.8
2017,Sep,60.8,57.9,9557643,9105971,451672,4.7
2017,Oct,60.7,57.9,9543205,9096611,446594,4.7
2017,Nov,60.6,57.8,9527547,9085925,441622,4.6
2017,Dec,60.6,57.8,9513789,9077369,436420,4.6
2018,Jan,60.5,57.8,9505817,9074847,430970,4.5
2018,Feb,60.5,57.8,9506088,9080635,425453,4.5
2018,Mar,60.6,57.9,9512599,9093681,418918,4.4
2018,Apr,60.6,58,9518802,9108362,410440,4.3
2018,May,60.7,58.1,9520394,9119951,400443,4.2
2018,Jun,60.7,58.2,9518221,9128479,389742,4.1
2018,Jul,60.6,58.2,9514970,9135281,379689,4
2018,Aug,60.7,58.3,9515399,9142250,373149,3.9
2018,Sep,60.7,58.3,9521482,9150233,371249,3.9
2018,Oct,60.8,58.4,9531730,9158403,373327,3.9
2018,Nov,60.8,58.4,9542679,9165087,377592,4
2018,Dec,60.9,58.5,9549429,9167089,382340,4
2019,Jan,60.9,58.4,9547462,9161783,385679,4
2019,Feb,60.8,58.4,9534512,9148538,385974,4
2019,Mar,60.7,58.3,9514746,9130757,383989,4
2019,Apr,60.6,58.2,9495586,9115005,380581,4
2019,May,60.6,58.2,9483005,9106058,376947,4
2019,Jun,60.6,58.2,9480192,9105741,374451,3.9
2019,Jul,60.6,58.2,9488460,9115194,373266,3.9
2019,Aug,60.7,58.3,9501909,9129585,372324,3.9
2019,Sep,60.8,58.4,9516997,9145414,371583,3.9
2019,Oct,60.9,58.5,9527899,9156652,371247,3.9
2019,Nov,60.9,58.5,9529070,9157857,371213,3.9
2019,Dec,60.9,58.5,9527712,9156258,371454,3.9
2020,Jan,61,58.7,9542921,9178410,364511,3.8
2020,Feb,61.1,58.8,9551655,9197589,354066,3.7
2020,Mar,60.2,57.7,9411433,9022695,388738,4.1
2020,Apr,58.1,49.2,9084012,7691738,1392274,15.3
2020,May,58.2,49.7,9089160,7770529,1318631,14.5
2020,Jun,60.1,50.7,9379581,7911749,1467832,15.6
2020,Jul,61.4,51.6,9580264,8054373,1525891,15.9
2020,Aug,60.8,53.2,9496930,8310258,1186672,12.5
2020,Sep,58.5,52.8,9134041,8249391,884650,9.7
