Year,Period,labor force participation rate,employment-population ratio,labor force,employment,unemployment,unemployment rate
1976,Jan,62.4,60.3,275609,266394,9215,3.3
1976,Feb,62.2,60.1,275468,266304,9164,3.3
1976,Mar,62.1,60,275531,266363,9168,3.3
1976,Apr,62.2,60.1,276266,266864,9402,3.4
1976,May,62.3,60.1,277312,267566,9746,3.5
1976,Jun,62.4,60.2,278512,268372,10140,3.6
1976,Jul,62.5,60.2,279594,269074,10520,3.8
1976,Aug,62.6,60.2,280450,269615,10835,3.9
1976,Sep,62.7,60.3,281118,270024,11094,3.9
1976,Oct,62.7,60.2,281650,270311,11339,4
1976,Nov,62.8,60.3,282162,270530,11632,4.1
1976,Dec,62.8,60.2,282737,270773,11964,4.2
1977,Jan,63,60.3,283410,271131,12279,4.3
1977,Feb,63,60.2,284158,271612,12546,4.4
1977,Mar,63,60.2,284891,272131,12760,4.5
1977,Apr,63.2,60.3,285557,272636,12921,4.5
1977,May,63.2,60.3,286183,273125,13058,4.6
1977,Jun,63.3,60.4,286814,273629,13185,4.6
1977,Jul,63.3,60.4,287469,274182,13287,4.6
1977,Aug,63.5,60.5,288183,274814,13369,4.6
1977,Sep,63.5,60.6,288953,275525,13428,4.6
1977,Oct,63.7,60.7,289681,276263,13418,4.6
1977,Nov,63.7,60.7,290272,276955,13317,4.6
1977,Dec,63.7,60.9,290685,277547,13138,4.5
1978,Jan,63.8,61,290982,278083,12899,4.4
1978,Feb,63.7,61,291302,278660,12642,4.3
1978,Mar,63.8,61.1,291766,279353,12413,4.3
1978,Apr,63.8,61.2,292396,280150,12246,4.2
1978,May,64,61.3,293102,280953,12149,4.1
1978,Jun,64,61.4,293777,281654,12123,4.1
1978,Jul,64.1,61.5,294379,282176,12203,4.1
1978,Aug,64.2,61.6,294868,282526,12342,4.2
1978,Sep,64.2,61.5,295265,282784,12481,4.2
1978,Oct,64.3,61.5,295684,283101,12583,4.3
1978,Nov,64.2,61.5,296192,283553,12639,4.3
1978,Dec,64.4,61.6,296800,284089,12711,4.3
1979,Jan,64.5,61.7,297467,284657,12810,4.3
1979,Feb,64.5,61.7,298124,285268,12856,4.3
1979,Mar,64.7,61.9,298722,285946,12776,4.3
1979,Apr,64.6,61.9,299240,286694,12546,4.2
1979,May,64.7,62.1,299692,287495,12197,4.1
1979,Jun,64.7,62.1,300079,288264,11815,3.9
1979,Jul,64.7,62.3,300402,288911,11491,3.8
1979,Aug,64.8,62.4,300655,289334,11321,3.8
1979,Sep,64.8,62.4,300827,289470,11357,3.8
1979,Oct,64.7,62.2,300906,289353,11553,3.8
1979,Nov,64.7,62.2,300962,289123,11839,3.9
1979,Dec,64.7,62.1,301077,288964,12113,4
1980,Jan,64.8,62.1,301266,288889,12377,4.1
1980,Feb,64.8,62.1,301513,288772,12741,4.2
1980,Mar,64.9,62,301805,288519,13286,4.4
1980,Apr,64.8,61.8,302117,288096,14021,4.6
1980,May,64.9,61.7,302432,287580,14852,4.9
1980,Jun,64.8,61.5,302771,287156,15615,5.2
1980,Jul,64.9,61.5,303167,287004,16163,5.3
1980,Aug,64.9,61.4,303682,287255,16427,5.4
1980,Sep,65,61.5,304357,287929,16428,5.4
1980,Oct,65.1,61.6,305160,288874,16286,5.3
1980,Nov,65.2,61.8,305971,289898,16073,5.3
1980,Dec,65.3,61.9,306680,290850,15830,5.2
1981,Jan,65.4,62,307231,291633,15598,5.1
1981,Feb,65.3,62,307597,292222,15375,5
1981,Mar,65.4,62.1,307818,292664,15154,4.9
1981,Apr,65.3,62.1,307992,293040,14952,4.9
1981,May,65.3,62.2,308245,293441,14804,4.8
1981,Jun,65.3,62.1,308674,293954,14720,4.8
1981,Jul,65.4,62.3,309310,294626,14684,4.7
1981,Aug,65.4,62.3,310099,295405,14694,4.7
1981,Sep,65.6,62.5,310936,296202,14734,4.7
1981,Oct,65.6,62.5,311705,296936,14769,4.7
1981,Nov,65.8,62.6,312320,297479,14841,4.8
1981,Dec,65.7,62.6,312784,297752,15032,4.8
1982,Jan,65.8,62.6,313163,297824,15339,4.9
1982,Feb,65.7,62.4,313552,297827,15725,5
1982,Mar,65.8,62.4,314018,297859,16159,5.1
1982,Apr,65.8,62.3,314603,298011,16592,5.3
1982,May,66,62.4,315274,298268,17006,5.4
1982,Jun,66,62.3,315942,298519,17423,5.5
1982,Jul,66.1,62.4,316525,298686,17839,5.6
1982,Aug,66,62.2,316979,298760,18219,5.7
1982,Sep,66,62.1,317336,298764,18572,5.9
1982,Oct,66,62.1,317675,298732,18943,6
1982,Nov,66,62,318069,298741,19328,6.1
1982,Dec,65.9,61.9,318480,298828,19652,6.2
1983,Jan,65.9,61.8,318838,298995,19843,6.2
1983,Feb,65.9,61.8,319114,299268,19846,6.2
1983,Mar,65.8,61.8,319290,299659,19631,6.1
1983,Apr,65.7,61.8,319389,300155,19234,6
1983,May,65.6,61.8,319476,300765,18711,5.9
1983,Jun,65.6,61.9,319625,301495,18130,5.7
1983,Jul,65.6,61.9,319909,302303,17606,5.5
1983,Aug,65.6,62.1,320335,303116,17219,5.4
1983,Sep,65.7,62.3,320840,303874,16966,5.3
1983,Oct,65.9,62.4,321351,304569,16782,5.2
1983,Nov,65.8,62.4,321835,305233,16602,5.2
1983,Dec,65.9,62.6,322363,305922,16441,5.1
1984,Jan,66.1,62.7,323019,306668,16351,5.1
1984,Feb,66.2,62.9,323817,307442,16375,5.1
1984,Mar,66.4,63,324722,308203,16519,5.1
1984,Apr,66.6,63.2,325653,308909,16744,5.1
1984,May,66.6,63.2,326519,309511,17008,5.2
1984,Jun,66.8,63.3,327244,309975,17269,5.3
1984,Jul,66.9,63.3,327760,310285,17475,5.3
1984,Aug,67,63.4,328074,310469,17605,5.4
1984,Sep,67.1,63.5,328282,310593,17689,5.4
1984,Oct,67.2,63.5,328519,310722,17797,5.4
1984,Nov,67.3,63.6,328908,310918,17990,5.5
1984,Dec,67.5,63.8,329459,311223,18236,5.5
1985,Jan,67.6,63.9,330103,311636,18467,5.6
1985,Feb,67.8,64,330767,312122,18645,5.6
1985,Mar,68,64.2,331368,312625,18743,5.7
1985,Apr,68.1,64.3,331850,313091,18759,5.7
1985,May,68.2,64.4,332214,313483,18731,5.6
1985,Jun,68.4,64.6,332515,313805,18710,5.6
1985,Jul,68.5,64.6,332830,314089,18741,5.6
1985,Aug,68.6,64.7,333203,314361,18842,5.7
1985,Sep,68.6,64.7,333610,314615,18995,5.7
1985,Oct,68.7,64.8,333983,314817,19166,5.7
1985,Nov,68.8,64.8,334245,314911,19334,5.8
1985,Dec,68.8,64.8,334380,314848,19532,5.8
1986,Jan,68.8,64.7,334399,314626,19773,5.9
1986,Feb,68.6,64.5,334299,314278,20021,6
1986,Mar,68.6,64.4,334081,313856,20225,6.1
1986,Apr,68.5,64.4,333759,313427,20332,6.1
1986,May,68.4,64.3,333322,313055,20267,6.1
1986,Jun,68.3,64.2,332781,312768,20013,6
1986,Jul,68.2,64.2,332201,312566,19635,5.9
1986,Aug,68.1,64.2,331664,312443,19221,5.8
1986,Sep,68.2,64.3,331235,312393,18842,5.7
1986,Oct,68.1,64.3,330936,312414,18522,5.6
1986,Nov,68.1,64.3,330737,312489,18248,5.5
1986,Dec,68.2,64.5,330601,312624,17977,5.4
1987,Jan,68.1,64.5,330466,312797,17669,5.3
1987,Feb,68.1,64.5,330321,312999,17322,5.2
1987,Mar,68.2,64.7,330210,313243,16967,5.1
1987,Apr,68.2,64.8,330184,313530,16654,5
1987,May,68.2,64.8,330295,313863,16432,5
1987,Jun,68.4,65.1,330555,314232,16323,4.9
1987,Jul,68.5,65.1,330909,314615,16294,4.9
1987,Aug,68.6,65.2,331274,314965,16309,4.9
1987,Sep,68.7,65.3,331602,315260,16342,4.9
1987,Oct,68.7,65.3,331854,315478,16376,4.9
1987,Nov,68.7,65.3,331975,315623,16352,4.9
1987,Dec,68.7,65.4,331920,315680,16240,4.9
1988,Jan,68.7,65.4,331708,315651,16057,4.8
1988,Feb,68.8,65.5,331401,315569,15832,4.8
1988,Mar,68.7,65.4,331082,315459,15623,4.7
1988,Apr,68.6,65.4,330848,315362,15486,4.7
1988,May,68.6,65.4,330759,315306,15453,4.7
1988,Jun,68.6,65.4,330794,315302,15492,4.7
1988,Jul,68.6,65.4,330891,315348,15543,4.7
1988,Aug,68.7,65.4,330986,315432,15554,4.7
1988,Sep,68.8,65.6,331011,315525,15486,4.7
1988,Oct,68.8,65.6,330926,315606,15320,4.6
1988,Nov,68.9,65.8,330771,315664,15107,4.6
1988,Dec,68.9,65.8,330612,315714,14898,4.5
1989,Jan,68.9,65.8,330509,315807,14702,4.4
1989,Feb,69,66,330493,315954,14539,4.4
1989,Mar,69,66,330554,316151,14403,4.4
1989,Apr,69.2,66.2,330647,316358,14289,4.3
1989,May,69.2,66.2,330722,316511,14211,4.3
1989,Jun,69.3,66.4,330739,316567,14172,4.3
1989,Jul,69.3,66.4,330678,316514,14164,4.3
1989,Aug,69.3,66.3,330535,316382,14153,4.3
1989,Sep,69.3,66.3,330339,316241,14098,4.3
1989,Oct,69.4,66.4,330156,316188,13968,4.2
1989,Nov,69.3,66.4,330041,316293,13748,4.2
1989,Dec,69.5,66.6,330041,316586,13455,4.1
1990,Jan,69.7,66.8,319500,306343,13157,4.1
1990,Feb,68.9,66,316586,303670,12916,4.1
1990,Mar,68.6,65.8,316037,303267,12770,4
1990,Apr,68.4,65.7,316229,303505,12724,4
1990,May,68.3,65.6,316628,303880,12748,4
1990,Jun,68.3,65.5,317043,304232,12811,4
1990,Jul,68.2,65.4,317383,304521,12862,4.1
1990,Aug,68.2,65.5,317589,304738,12851,4
1990,Sep,68.2,65.5,317638,304863,12775,4
1990,Oct,68.2,65.5,317542,304865,12677,4
1990,Nov,68.3,65.6,317361,304737,12624,4
1990,Dec,68.2,65.5,317133,304452,12681,4
1991,Jan,68.2,65.4,316868,303994,12874,4.1
1991,Feb,68.2,65.4,316575,303408,13167,4.2
1991,Mar,68.1,65.2,316228,302735,13493,4.3
1991,Apr,68,65.1,315831,302060,13771,4.4
1991,May,68.1,65.1,315429,301498,13931,4.4
1991,Jun,68,65,315055,301102,13953,4.4
1991,Jul,67.9,64.9,314742,300862,13880,4.4
1991,Aug,67.9,64.9,314526,300725,13801,4.4
1991,Sep,67.8,64.9,314425,300627,13798,4.4
1991,Oct,67.7,64.7,314433,300513,13920,4.4
1991,Nov,67.7,64.6,314524,300372,14152,4.5
1991,Dec,67.7,64.6,314650,300221,14429,4.6
1992,Jan,67.7,64.6,314801,300108,14693,4.7
1992,Feb,67.8,64.5,314955,300052,14903,4.7
1992,Mar,67.8,64.5,315121,300080,15041,4.8
1992,Apr,67.8,64.5,315269,300164,15105,4.8
1992,May,67.7,64.4,315370,300256,15114,4.8
1992,Jun,67.7,64.4,315465,300365,15100,4.8
1992,Jul,67.7,64.5,315626,300537,15089,4.8
1992,Aug,67.7,64.5,315911,300824,15087,4.8
1992,Sep,67.7,64.5,316305,301251,15054,4.8
1992,Oct,67.8,64.6,316773,301821,14952,4.7
1992,Nov,67.9,64.7,317271,302492,14779,4.7
1992,Dec,68,64.9,317817,303249,14568,4.6
1993,Jan,67.9,64.9,318427,304074,14353,4.5
1993,Feb,68.1,65.1,319107,304938,14169,4.4
1993,Mar,68.2,65.2,319871,305832,14039,4.4
1993,Apr,68.4,65.4,320727,306762,13965,4.4
1993,May,68.6,65.6,321679,307742,13937,4.3
1993,Jun,68.7,65.7,322719,308797,13922,4.3
1993,Jul,68.9,65.9,323856,309967,13889,4.3
1993,Aug,69.1,66.2,325117,311288,13829,4.3
1993,Sep,69.3,66.4,326549,312798,13751,4.2
1993,Oct,69.6,66.7,328153,314466,13687,4.2
1993,Nov,70,67.1,329855,316215,13640,4.1
1993,Dec,70.2,67.3,331539,317961,13578,4.1
1994,Jan,70.5,67.6,333081,319620,13461,4
1994,Feb,70.8,67.9,334402,321124,13278,4
1994,Mar,71,68.2,335483,322432,13051,3.9
1994,Apr,71,68.3,336355,323545,12810,3.8
1994,May,71.1,68.5,337074,324476,12598,3.7
1994,Jun,71.3,68.6,337648,325222,12426,3.7
1994,Jul,71.3,68.7,338046,325757,12289,3.6
1994,Aug,71.2,68.6,338233,326045,12188,3.6
1994,Sep,71.2,68.6,338186,326062,12124,3.6
1994,Oct,71.1,68.6,337927,325864,12063,3.6
1994,Nov,70.9,68.4,337549,325580,11969,3.5
1994,Dec,70.8,68.3,337179,325343,11836,3.5
1995,Jan,70.7,68.3,336945,325287,11658,3.5
1995,Feb,70.7,68.3,336963,325518,11445,3.4
1995,Mar,70.6,68.3,337273,326062,11211,3.3
1995,Apr,70.7,68.4,337864,326877,10987,3.3
1995,May,70.9,68.6,338680,327864,10816,3.2
1995,Jun,71.1,68.8,339650,328909,10741,3.2
1995,Jul,71.1,68.9,340682,329925,10757,3.2
1995,Aug,71.3,69.1,341663,330865,10798,3.2
1995,Sep,71.4,69.1,342538,331734,10804,3.2
1995,Oct,71.5,69.3,343297,332543,10754,3.1
1995,Nov,71.6,69.4,343944,333262,10682,3.1
1995,Dec,71.6,69.4,344470,333862,10608,3.1
1996,Jan,71.7,69.5,344886,334357,10529,3.1
1996,Feb,71.7,69.6,345239,334797,10442,3
1996,Mar,71.6,69.5,345593,335240,10353,3
1996,Apr,71.7,69.6,345999,335734,10265,3
1996,May,71.8,69.7,346482,336322,10160,2.9
1996,Jun,71.8,69.7,347041,337002,10039,2.9
1996,Jul,71.9,69.8,347667,337726,9941,2.9
1996,Aug,72,70,348348,338440,9908,2.8
1996,Sep,72,69.9,349023,339090,9933,2.8
1996,Oct,72.1,70,349610,339658,9952,2.8
1996,Nov,72.2,70.1,350073,340172,9901,2.8
1996,Dec,72.3,70.2,350475,340643,9832,2.8
1997,Jan,72.3,70.3,350889,341042,9847,2.8
1997,Feb,72.4,70.3,351296,341331,9965,2.8
1997,Mar,72.5,70.4,351628,341501,10127,2.9
1997,Apr,72.5,70.4,351828,341570,10258,2.9
1997,May,72.5,70.4,351869,341578,10291,2.9
1997,Jun,72.5,70.4,351750,341582,10168,2.9
1997,Jul,72.4,70.4,351530,341657,9873,2.8
1997,Aug,72.3,70.4,351301,341842,9459,2.7
1997,Sep,72.1,70.3,351146,342105,9041,2.6
1997,Oct,72.1,70.3,351143,342373,8770,2.5
1997,Nov,72.2,70.4,351271,342567,8704,2.5
1997,Dec,72.3,70.5,351403,342643,8760,2.5
1998,Jan,72.3,70.5,351408,342550,8858,2.5
1998,Feb,72.3,70.4,351261,342275,8986,2.6
1998,Mar,72.2,70.3,351005,341853,9152,2.6
1998,Apr,72.1,70.2,350675,341314,9361,2.7
1998,May,72,70.1,350308,340697,9611,2.7
1998,Jun,72,69.9,349955,340057,9898,2.8
1998,Jul,71.9,69.8,349602,339393,10209,2.9
1998,Aug,71.8,69.6,349204,338685,10519,3
1998,Sep,71.7,69.5,348746,337926,10820,3.1
1998,Oct,71.5,69.3,348179,337081,11098,3.2
1998,Nov,71.4,69.1,347477,336143,11334,3.3
1998,Dec,71.2,68.9,346686,335163,11523,3.3
1999,Jan,71.2,68.8,345864,334239,11625,3.4
1999,Feb,71,68.6,345095,333458,11637,3.4
1999,Mar,70.9,68.5,344425,332842,11583,3.4
1999,Apr,70.8,68.4,343892,332414,11478,3.3
1999,May,70.7,68.3,343511,332138,11373,3.3
1999,Jun,70.7,68.4,343240,331938,11302,3.3
1999,Jul,70.7,68.4,343042,331782,11260,3.3
1999,Aug,70.6,68.3,342893,331665,11228,3.3
1999,Sep,70.6,68.3,342728,331567,11161,3.3
1999,Oct,70.6,68.3,342539,331505,11034,3.2
1999,Nov,70.5,68.3,342352,331488,10864,3.2
1999,Dec,70.5,68.3,342174,331496,10678,3.1
2000,Jan,70.4,68.3,342007,331508,10499,3.1
2000,Feb,70.4,68.2,341842,331527,10315,3
2000,Mar,70.3,68.3,341752,331604,10148,3
2000,Apr,70.5,68.4,341804,331754,10050,2.9
2000,May,70.5,68.5,341975,331965,10010,2.9
2000,Jun,70.6,68.5,342231,332207,10024,2.9
2000,Jul,70.7,68.6,342537,332439,10098,2.9
2000,Aug,70.7,68.6,342854,332675,10179,3
2000,Sep,70.8,68.7,343158,332952,10206,3
2000,Oct,70.8,68.8,343428,333289,10139,3
2000,Nov,70.9,68.8,343651,333665,9986,2.9
2000,Dec,70.9,68.9,343831,334028,9803,2.9
2001,Jan,71,69,343985,334336,9649,2.8
2001,Feb,71,69,344071,334506,9565,2.8
2001,Mar,71,69,343952,334401,9551,2.8
2001,Apr,70.9,69,343550,333973,9577,2.8
2001,May,70.8,68.8,342931,333285,9646,2.8
2001,Jun,70.6,68.6,342173,332443,9730,2.8
2001,Jul,70.5,68.5,341370,331558,9812,2.9
2001,Aug,70.3,68.3,340630,330688,9942,2.9
2001,Sep,70.2,68.1,340068,329903,10165,3
2001,Oct,70.1,67.9,339744,329262,10482,3.1
2001,Nov,70.1,67.8,339655,328774,10881,3.2
2001,Dec,70.1,67.8,339759,328430,11329,3.3
2002,Jan,70.2,67.7,339977,328192,11785,3.5
2002,Feb,70.2,67.7,340232,328031,12201,3.6
2002,Mar,70.3,67.7,340483,327951,12532,3.7
2002,Apr,70.3,67.7,340685,327939,12746,3.7
2002,May,70.3,67.7,340792,327951,12841,3.8
2002,Jun,70.3,67.7,340817,327961,12856,3.8
2002,Jul,70.3,67.7,340790,327958,12832,3.8
2002,Aug,70.3,67.7,340739,327946,12793,3.8
2002,Sep,70.3,67.6,340697,327915,12782,3.8
2002,Oct,70.3,67.6,340695,327867,12828,3.8
2002,Nov,70.3,67.6,340762,327841,12921,3.8
2002,Dec,70.3,67.6,340891,327866,13025,3.8
2003,Jan,70.3,67.6,341085,327976,13109,3.8
2003,Feb,70.4,67.7,341348,328203,13145,3.9
2003,Mar,70.5,67.8,341721,328585,13136,3.8
2003,Apr,70.6,67.9,342247,329149,13098,3.8
2003,May,70.7,68,342940,329917,13023,3.8
2003,Jun,70.9,68.2,343812,330893,12919,3.8
2003,Jul,71.1,68.4,344812,332011,12801,3.7
2003,Aug,71.2,68.6,345864,333173,12691,3.7
2003,Sep,71.4,68.8,346861,334276,12585,3.6
2003,Oct,71.5,68.9,347736,335244,12492,3.6
2003,Nov,71.6,69,348453,336054,12399,3.6
2003,Dec,71.6,69.1,349035,336743,12292,3.5
2004,Jan,71.7,69.2,349528,337355,12173,3.5
2004,Feb,71.7,69.3,350021,337971,12050,3.4
2004,Mar,71.8,69.4,350585,338650,11935,3.4
2004,Apr,71.9,69.4,351211,339357,11854,3.4
2004,May,71.9,69.5,351874,340031,11843,3.4
2004,Jun,72,69.6,352515,340628,11887,3.4
2004,Jul,72.1,69.6,353096,341131,11965,3.4
2004,Aug,72.1,69.7,353596,341535,12061,3.4
2004,Sep,72.2,69.7,353979,341839,12140,3.4
2004,Oct,72.2,69.7,354225,342041,12184,3.4
2004,Nov,72.2,69.7,354335,342148,12187,3.4
2004,Dec,72.2,69.7,354364,342196,12168,3.4
2005,Jan,72.2,69.7,354362,342214,12148,3.4
2005,Feb,72.2,69.7,354346,342207,12139,3.4
2005,Mar,72.2,69.7,354342,342212,12130,3.4
2005,Apr,72.2,69.7,354427,342313,12114,3.4
2005,May,72.2,69.7,354663,342558,12105,3.4
2005,Jun,72.2,69.8,355041,342931,12110,3.4
2005,Jul,72.3,69.8,355508,343393,12115,3.4
2005,Aug,72.4,69.9,355993,343904,12089,3.4
2005,Sep,72.5,70,356457,344430,12027,3.4
2005,Oct,72.5,70,356888,344961,11927,3.3
2005,Nov,72.5,70.1,357295,345492,11803,3.3
2005,Dec,72.6,70.2,357696,346022,11674,3.3
2006,Jan,72.6,70.3,358126,346574,11552,3.2
2006,Feb,72.7,70.4,358598,347130,11468,3.2
2006,Mar,72.8,70.5,359095,347641,11454,3.2
2006,Apr,72.9,70.6,359588,348103,11485,3.2
2006,May,72.9,70.6,360068,348553,11515,3.2
2006,Jun,73,70.7,360612,349044,11568,3.2
2006,Jul,73.1,70.8,361304,349643,11661,3.2
2006,Aug,73.3,70.9,362160,350401,11759,3.2
2006,Sep,73.5,71.1,363136,351310,11826,3.3
2006,Oct,73.6,71.2,364148,352315,11833,3.2
2006,Nov,73.8,71.4,365083,353298,11785,3.2
2006,Dec,73.9,71.6,365830,354130,11700,3.2
2007,Jan,74,71.7,366337,354735,11602,3.2
2007,Feb,74.1,71.7,366645,355131,11514,3.1
2007,Mar,74.1,71.8,366803,355355,11448,3.1
2007,Apr,74.1,71.8,366865,355438,11427,3.1
2007,May,74.1,71.7,366896,355440,11456,3.1
2007,Jun,74,71.7,366921,355444,11477,3.1
2007,Jul,74,71.7,366982,355500,11482,3.1
2007,Aug,74,71.7,367162,355651,11511,3.1
2007,Sep,74,71.7,367481,355942,11539,3.1
2007,Oct,74.1,71.8,367905,356385,11520,3.1
2007,Nov,74.1,71.8,368403,356983,11420,3.1
2007,Dec,74.2,71.9,368962,357712,11250,3
2008,Jan,74.3,72.1,369532,358473,11059,3
2008,Feb,74.4,72.2,370098,359175,10923,3
2008,Mar,74.5,72.3,370687,359770,10917,2.9
2008,Apr,74.5,72.3,371282,360224,11058,3
2008,May,74.6,72.3,371804,360496,11308,3
2008,Jun,74.6,72.3,372162,360557,11605,3.1
2008,Jul,74.6,72.2,372248,360409,11839,3.2
2008,Aug,74.5,72.1,372016,360038,11978,3.2
2008,Sep,74.3,71.9,371582,359437,12145,3.3
2008,Oct,74.2,71.7,371091,358640,12451,3.4
2008,Nov,74,71.4,370602,357655,12947,3.5
2008,Dec,73.9,71.2,370134,356512,13622,3.7
2009,Jan,73.7,70.9,369699,355313,14386,3.9
2009,Feb,73.6,70.6,369267,354188,15079,4.1
2009,Mar,73.4,70.4,368802,353254,15548,4.2
2009,Apr,73.3,70.2,368329,352605,15724,4.3
2009,May,73.2,70.1,367902,352266,15636,4.3
2009,Jun,73,70,367599,352206,15393,4.2
2009,Jul,73,69.9,367505,352358,15147,4.1
2009,Aug,72.9,69.9,367650,352669,14981,4.1
2009,Sep,72.9,69.9,367995,353121,14874,4
2009,Oct,72.9,70,368563,353720,14843,4
2009,Nov,73,70.1,369444,354569,14875,4
2009,Dec,73.2,70.2,370664,355769,14895,4
2010,Jan,73.4,70.5,372147,357286,14861,4
2010,Feb,73.7,70.8,373754,358981,14773,4
2010,Mar,73.9,71,375337,360682,14655,3.9
2010,Apr,72,69.2,376728,362204,14524,3.9
2010,May,72.2,69.4,377828,363433,14395,3.8
2010,Jun,72.2,69.5,378633,364357,14276,3.8
2010,Jul,72.3,69.6,379228,365054,14174,3.7
2010,Aug,72.3,69.6,379763,365670,14093,3.7
2010,Sep,72.3,69.6,380374,366342,14032,3.7
2010,Oct,72.3,69.7,381116,367162,13954,3.7
2010,Nov,72.4,69.8,381964,368119,13845,3.6
2010,Dec,72.5,69.9,382864,369132,13732,3.6
2011,Jan,72.5,70,383753,370131,13622,3.5
2011,Feb,72.6,70.1,384575,371059,13516,3.5
2011,Mar,72.7,70.1,385333,371889,13444,3.5
2011,Apr,72.7,70.2,386114,372677,13437,3.5
2011,May,72.8,70.3,386995,373491,13504,3.5
2011,Jun,72.9,70.3,387988,374372,13616,3.5
2011,Jul,73,70.4,389060,375345,13715,3.5
2011,Aug,73.1,70.5,390144,376405,13739,3.5
2011,Sep,73.1,70.6,391160,377505,13655,3.5
2011,Oct,73.2,70.6,392024,378566,13458,3.4
2011,Nov,73.2,70.7,392693,379527,13166,3.4
2011,Dec,73.2,70.8,393205,380385,12820,3.3
2012,Jan,73.1,70.8,393660,381180,12480,3.2
2012,Feb,73.1,70.8,394174,381964,12210,3.1
2012,Mar,73.1,70.9,394788,382755,12033,3
2012,Apr,73.1,70.9,395496,383552,11944,3
2012,May,73.1,70.9,396309,384374,11935,3
2012,Jun,73.2,71,397207,385218,11989,3
2012,Jul,73.2,71,398143,386061,12082,3
2012,Aug,73.2,71,399078,386881,12197,3.1
2012,Sep,73.2,71,399994,387687,12307,3.1
2012,Oct,73.2,71,400894,388519,12375,3.1
2012,Nov,73.2,70.9,401779,389375,12404,3.1
2012,Dec,73.2,70.9,402642,390233,12409,3.1
2013,Jan,73.1,70.8,402891,390510,12381,3.1
2013,Feb,73.1,70.8,403668,391355,12313,3.1
2013,Mar,73.1,70.8,404388,392174,12214,3
2013,Apr,73,70.8,405056,392959,12097,3
2013,May,73,70.8,405653,393686,11967,3
2013,Jun,72.9,70.8,406196,394364,11832,2.9
2013,Jul,72.8,70.7,406698,394991,11707,2.9
2013,Aug,72.8,70.7,407135,395535,11600,2.8
2013,Sep,72.7,70.6,407517,395998,11519,2.8
2013,Oct,72.6,70.6,407874,396414,11460,2.8
2013,Nov,72.6,70.6,408253,396865,11388,2.8
2013,Dec,72.5,70.5,408710,397430,11280,2.8
2014,Jan,72.4,70.4,408496,397358,11138,2.7
2014,Feb,72.4,70.5,409283,398255,11028,2.7
2014,Mar,72.5,70.6,410270,399334,10936,2.7
2014,Apr,72.6,70.7,411375,400499,10876,2.6
2014,May,72.7,70.7,412512,401649,10863,2.6
2014,Jun,72.7,70.8,413619,402712,10907,2.6
2014,Jul,72.8,70.9,414646,403648,10998,2.7
2014,Aug,72.8,70.9,415557,404458,11099,2.7
2014,Sep,72.8,70.9,416266,405103,11163,2.7
2014,Oct,72.8,70.8,416697,405528,11169,2.7
2014,Nov,72.7,70.7,416803,405688,11115,2.7
2014,Dec,72.5,70.6,416590,405551,11039,2.6
2015,Jan,72.3,70.4,415928,404928,11000,2.6
2015,Feb,72.1,70.2,415263,404214,11049,2.7
2015,Mar,71.9,69.9,414521,403334,11187,2.7
2015,Apr,71.6,69.7,413808,402421,11387,2.8
2015,May,71.4,69.4,413172,401589,11583,2.8
2015,Jun,71.2,69.2,412612,400901,11711,2.8
2015,Jul,71,69,412143,400406,11737,2.8
2015,Aug,70.9,68.9,411807,400103,11704,2.8
2015,Sep,70.9,68.9,411636,399941,11695,2.8
2015,Oct,70.9,68.9,411638,399835,11803,2.9
2015,Nov,70.9,68.9,411785,399710,12075,2.9
2015,Dec,71,68.9,412017,399545,12472,3
2016,Jan,71.1,68.8,412241,399340,12901,3.1
2016,Feb,71.1,68.8,412403,399138,13265,3.2
2016,Mar,71.1,68.8,412508,399025,13483,3.3
2016,Apr,71.2,68.8,412596,399083,13513,3.3
2016,May,71.2,68.9,412696,399332,13364,3.2
2016,Jun,71.2,69,412789,399704,13085,3.2
2016,Jul,71.2,69,412830,400070,12760,3.1
2016,Aug,71.2,69.1,412784,400315,12469,3
2016,Sep,71.2,69.1,412648,400406,12242,3
2016,Oct,71.2,69.1,412441,400363,12078,2.9
2016,Nov,71.1,69.1,412209,400270,11939,2.9
2016,Dec,71.1,69.1,411997,400214,11783,2.9
2017,Jan,71.1,69.1,411825,400253,11572,2.8
2017,Feb,71.1,69.1,411676,400375,11301,2.7
2017,Mar,71.1,69.2,411474,400473,11001,2.7
2017,Apr,71,69.2,411179,400441,10738,2.6
2017,May,71,69.1,410788,400217,10571,2.6
2017,Jun,70.9,69.1,410317,399784,10533,2.6
2017,Jul,70.8,69,409790,399175,10615,2.6
2017,Aug,70.7,68.8,409222,398467,10755,2.6
2017,Sep,70.5,68.7,408624,397731,10893,2.7
2017,Oct,70.4,68.5,408014,397043,10971,2.7
2017,Nov,70.3,68.4,407395,396404,10991,2.7
2017,Dec,70.2,68.3,406774,395797,10977,2.7
2018,Jan,70.1,68.2,406159,395224,10935,2.7
2018,Feb,70,68.1,405555,394685,10870,2.7
2018,Mar,69.8,68,404957,394168,10789,2.7
2018,Apr,69.7,67.9,404346,393648,10698,2.6
2018,May,69.6,67.8,403744,393132,10612,2.6
2018,Jun,69.5,67.7,403209,392679,10530,2.6
2018,Jul,69.4,67.6,402786,392352,10434,2.6
2018,Aug,69.3,67.6,402507,392194,10313,2.6
2018,Sep,69.3,67.5,402385,392224,10161,2.5
2018,Oct,69.3,67.5,402400,392421,9979,2.5
2018,Nov,69.3,67.6,402505,392744,9761,2.4
2018,Dec,69.3,67.6,402661,393123,9538,2.4
2019,Jan,69.3,67.7,402833,393461,9372,2.3
2019,Feb,69.3,67.7,403000,393695,9305,2.3
2019,Mar,69.3,67.7,403162,393816,9346,2.3
2019,Apr,69.3,67.7,403330,393862,9468,2.3
2019,May,69.3,67.7,403494,393870,9624,2.4
2019,Jun,69.3,67.7,403647,393878,9769,2.4
2019,Jul,69.3,67.6,403815,393961,9854,2.4
2019,Aug,69.3,67.6,403898,394044,9854,2.4
2019,Sep,69.3,67.6,403977,394189,9788,2.4
2019,Oct,69.2,67.6,404014,394318,9696,2.4
2019,Nov,69.2,67.6,403988,394349,9639,2.4
2019,Dec,69.2,67.5,403982,394353,9629,2.4
2020,Jan,69.2,67.6,404282,394947,9335,2.3
2020,Feb,69.2,67.7,404488,395451,9037,2.2
2020,Mar,69.4,68,405729,397604,8125,2
2020,Apr,69.5,63.2,406657,369752,36905,9.1
2020,May,68.8,62.5,402457,365917,36540,9.1
2020,Jun,69,63.9,403755,373922,29833,7.4
2020,Jul,68.7,64.1,402156,375547,26609,6.6
2020,Aug,67.8,64.4,397335,377282,20053,5
2020,Sep,67.6,64.6,396309,379040,17269,4.4
