Year,Period,labor force participation rate,employment-population ratio,labor force,employment,unemployment,unemployment rate
1976,Jan,63.8,60.1,5627987,5298778,329209,5.8
1976,Feb,63.6,59.9,5624823,5295497,329326,5.9
1976,Mar,63.5,59.7,5629458,5299209,330249,5.9
1976,Apr,63.5,59.8,5653373,5321425,331948,5.9
1976,May,63.7,60,5684052,5350734,333318,5.9
1976,Jun,63.9,60.1,5714998,5381718,333280,5.8
1976,Jul,64,60.3,5739119,5407584,331535,5.8
1976,Aug,64,60.3,5755786,5426895,328891,5.7
1976,Sep,64,60.3,5770305,5443387,326918,5.7
1976,Oct,64,60.4,5785215,5458404,326811,5.6
1976,Nov,64,60.4,5802339,5473608,328731,5.7
1976,Dec,64,60.4,5821892,5490841,331051,5.7
1977,Jan,64.1,60.5,5843715,5511563,332152,5.7
1977,Feb,64.2,60.6,5865786,5535189,330597,5.6
1977,Mar,64.2,60.7,5885057,5559030,326027,5.5
1977,Apr,64.3,60.8,5900976,5581449,319527,5.4
1977,May,64.2,60.8,5915306,5602054,313252,5.3
1977,Jun,64.2,60.9,5930627,5621018,309609,5.2
1977,Jul,64.3,60.9,5948949,5639897,309052,5.2
1977,Aug,64.4,61,5971461,5660471,310990,5.2
1977,Sep,64.5,61.1,5997396,5683524,313872,5.2
1977,Oct,64.6,61.2,6024246,5708323,315923,5.2
1977,Nov,64.7,61.3,6049565,5733214,316351,5.2
1977,Dec,64.8,61.4,6071388,5756351,315037,5.2
1978,Jan,64.8,61.5,6090069,5778355,311714,5.1
1978,Feb,64.8,61.6,6107801,5800680,307121,5
1978,Mar,64.9,61.7,6126483,5824121,302362,4.9
1978,Apr,64.9,61.8,6146584,5848514,298070,4.8
1978,May,65,61.9,6168511,5873637,294874,4.8
1978,Jun,65.1,62,6192173,5899185,292988,4.7
1978,Jul,65.2,62.1,6217451,5924030,293421,4.7
1978,Aug,65.2,62.1,6243179,5947634,295545,4.7
1978,Sep,65.3,62.2,6268160,5971075,297085,4.7
1978,Oct,65.4,62.3,6292671,5996126,296545,4.7
1978,Nov,65.4,62.4,6316381,6022940,293441,4.6
1978,Dec,65.4,62.5,6337938,6049161,288777,4.6
1979,Jan,65.4,62.5,6355993,6072281,283712,4.5
1979,Feb,65.4,62.5,6371423,6092317,279106,4.4
1979,Mar,65.4,62.6,6386829,6110727,276102,4.3
1979,Apr,65.4,62.6,6405159,6129384,275775,4.3
1979,May,65.4,62.6,6427782,6150075,277707,4.3
1979,Jun,65.5,62.6,6453188,6172466,280722,4.4
1979,Jul,65.6,62.7,6479252,6196822,282430,4.4
1979,Aug,65.6,62.8,6505104,6222616,282488,4.3
1979,Sep,65.7,62.8,6530768,6248171,282597,4.3
1979,Oct,65.7,62.9,6556039,6272510,283529,4.3
1979,Nov,65.8,62.9,6581769,6295448,286321,4.4
1979,Dec,65.9,62.9,6609263,6316803,292460,4.4
1980,Jan,65.9,62.9,6637791,6335078,302713,4.6
1980,Feb,66,62.9,6664900,6348569,316331,4.7
1980,Mar,66,62.8,6688533,6357152,331381,5
1980,Apr,66,62.6,6706951,6362265,344686,5.1
1980,May,66,62.5,6720742,6366680,354062,5.3
1980,Jun,66,62.4,6734210,6374931,359279,5.3
1980,Jul,65.9,62.4,6750256,6389170,361086,5.3
1980,Aug,66,62.4,6770147,6409449,360698,5.3
1980,Sep,66,62.5,6794147,6434553,359594,5.3
1980,Oct,66.1,62.6,6821438,6461970,359468,5.3
1980,Nov,66.2,62.8,6851048,6490940,360108,5.3
1980,Dec,66.4,62.9,6883288,6522615,360673,5.2
1981,Jan,66.5,63.1,6917849,6556298,361551,5.2
1981,Feb,66.7,63.2,6952803,6589945,362858,5.2
1981,Mar,66.9,63.4,6986833,6622566,364267,5.2
1981,Apr,67,63.5,7018173,6652082,366091,5.2
1981,May,67.1,63.6,7044569,6676419,368150,5.2
1981,Jun,67.1,63.6,7065709,6695768,369941,5.2
1981,Jul,67.1,63.6,7083018,6710972,372046,5.3
1981,Aug,67,63.5,7098212,6723539,374673,5.3
1981,Sep,66.9,63.4,7113539,6735583,377956,5.3
1981,Oct,66.9,63.3,7131325,6748482,382843,5.4
1981,Nov,66.8,63.2,7151260,6761143,390117,5.5
1981,Dec,66.8,63.1,7173437,6773572,399865,5.6
1982,Jan,66.8,63,7198777,6787708,411069,5.7
1982,Feb,66.9,62.9,7228118,6804090,424028,5.9
1982,Mar,66.9,62.9,7260392,6821426,438966,6
1982,Apr,67,62.9,7294863,6839478,455385,6.2
1982,May,67.1,62.8,7330460,6857570,472890,6.5
1982,Jun,67.2,62.7,7364774,6873473,491301,6.7
1982,Jul,67.3,62.7,7397371,6886244,511127,6.9
1982,Aug,67.4,62.6,7429213,6896037,533176,7.2
1982,Sep,67.6,62.5,7460493,6903169,557324,7.5
1982,Oct,67.7,62.4,7490775,6908614,582161,7.8
1982,Nov,67.8,62.3,7519583,6914130,605453,8.1
1982,Dec,67.8,62.2,7543336,6919409,623927,8.3
1983,Jan,67.8,62.1,7560844,6924652,636192,8.4
1983,Feb,67.8,62,7574330,6932802,641528,8.5
1983,Mar,67.7,62,7586596,6946093,640503,8.4
1983,Apr,67.7,62,7601840,6966048,635792,8.4
1983,May,67.7,62.1,7621730,6992199,629531,8.3
1983,Jun,67.8,62.2,7644471,7022295,622176,8.1
1983,Jul,67.8,62.4,7666775,7053672,613103,8
1983,Aug,67.8,62.5,7684526,7082471,602055,7.8
1983,Sep,67.8,62.6,7694426,7106089,588337,7.6
1983,Oct,67.7,62.7,7695977,7124533,571444,7.4
1983,Nov,67.6,62.7,7692297,7139315,552982,7.2
1983,Dec,67.4,62.7,7688988,7153561,535427,7
1984,Jan,67.3,62.8,7689359,7170636,518723,6.7
1984,Feb,67.2,62.8,7693879,7191301,502578,6.5
1984,Mar,67.2,62.9,7701838,7213604,488234,6.3
1984,Apr,67.2,63,7709908,7234031,475877,6.2
1984,May,68.2,64.1,7840905,7374389,466516,5.9
1984,Jun,68.4,64.4,7883665,7422787,460878,5.8
1984,Jul,68.5,64.5,7898829,7439916,458913,5.8
1984,Aug,68.4,64.4,7907255,7446145,461110,5.8
1984,Sep,68.4,64.4,7917375,7449495,467880,5.9
1984,Oct,68.4,64.3,7932600,7454260,478340,6
1984,Nov,68.5,64.3,7953218,7462918,490300,6.2
1984,Dec,68.6,64.3,7976672,7474652,502020,6.3
1985,Jan,68.6,64.2,7998343,7484932,513411,6.4
1985,Feb,68.7,64.2,8014082,7489140,524942,6.6
1985,Mar,68.6,64,8021570,7485636,535934,6.7
1985,Apr,68.5,63.9,8021915,7475793,546122,6.8
1985,May,68.4,63.6,8018956,7462899,556057,6.9
1985,Jun,68.3,63.4,8017427,7451462,565965,7.1
1985,Jul,68.2,63.3,8020208,7444654,575554,7.2
1985,Aug,68.1,63.2,8026736,7444572,582164,7.3
1985,Sep,68.1,63.1,8035444,7449910,585534,7.3
1985,Oct,68.1,63.1,8044556,7456083,588473,7.3
1985,Nov,68.1,63,8052732,7458747,593985,7.4
1985,Dec,68,62.9,8060684,7455924,604760,7.5
1986,Jan,68,62.8,8071823,7449243,622580,7.7
1986,Feb,68.1,62.7,8089551,7442856,646695,8
1986,Mar,68.2,62.5,8113485,7440192,673293,8.3
1986,Apr,68.3,62.5,8141016,7442665,698351,8.6
1986,May,68.5,62.4,8167653,7449293,718360,8.8
1986,Jun,68.6,62.4,8190515,7458133,732382,8.9
1986,Jul,68.6,62.4,8208764,7467166,741598,9
1986,Aug,68.7,62.5,8222473,7474205,748268,9.1
1986,Sep,68.8,62.5,8232427,7478872,753555,9.2
1986,Oct,68.8,62.5,8239269,7482823,756446,9.2
1986,Nov,68.8,62.5,8243079,7486771,756308,9.2
1986,Dec,68.8,62.5,8245423,7493133,752290,9.1
1987,Jan,68.8,62.6,8247221,7502987,744234,9
1987,Feb,68.8,62.6,8248301,7515113,733188,8.9
1987,Mar,68.8,62.7,8251106,7529047,722059,8.8
1987,Apr,68.8,62.8,8256519,7544050,712469,8.6
1987,May,68.8,62.9,8263718,7559154,704564,8.5
1987,Jun,68.8,63,8271694,7573316,698378,8.4
1987,Jul,68.9,63.1,8279326,7586330,692996,8.4
1987,Aug,68.9,63.2,8286108,7598548,687560,8.3
1987,Sep,68.9,63.3,8292290,7611143,681147,8.2
1987,Oct,69,63.4,8298109,7623766,674343,8.1
1987,Nov,69,63.4,8303798,7636645,667153,8
1987,Dec,69,63.5,8308284,7648563,659721,7.9
1988,Jan,69,63.6,8310417,7658622,651795,7.8
1988,Feb,69,63.6,8310909,7667981,642928,7.7
1988,Mar,69,63.7,8310563,7677058,633505,7.6
1988,Apr,68.9,63.8,8311114,7686700,624414,7.5
1988,May,68.9,63.8,8314445,7698019,616426,7.4
1988,Jun,69,63.9,8321207,7711522,609685,7.3
1988,Jul,69,64,8330911,7726706,604205,7.3
1988,Aug,69.1,64.1,8343121,7742732,600389,7.2
1988,Sep,69.1,64.2,8357125,7759256,597869,7.2
1988,Oct,69.1,64.2,8371253,7776661,594592,7.1
1988,Nov,69.2,64.3,8384619,7794632,589987,7
1988,Dec,69.2,64.4,8395820,7811712,584108,7
1989,Jan,69.2,64.5,8404227,7827072,577155,6.9
1989,Feb,69.2,64.5,8409931,7839021,570910,6.8
1989,Mar,69.1,64.5,8414266,7848129,566137,6.7
1989,Apr,69.1,64.5,8418409,7855400,563009,6.7
1989,May,69.1,64.5,8423286,7861654,561632,6.7
1989,Jun,69,64.4,8430102,7868305,561797,6.7
1989,Jul,69,64.4,8439188,7876342,562846,6.7
1989,Aug,69.1,64.5,8449365,7886829,562536,6.7
1989,Sep,69.1,64.5,8459907,7900223,559684,6.6
1989,Oct,69.1,64.6,8472561,7917719,554842,6.5
1989,Nov,69.1,64.7,8487907,7939082,548825,6.5
1989,Dec,69.2,64.8,8506920,7963451,543469,6.4
1990,Jan,67.9,63.6,8529504,7989578,539926,6.3
1990,Feb,68.1,63.8,8553003,8015501,537502,6.3
1990,Mar,68.2,64,8574321,8038318,536003,6.3
1990,Apr,68.3,64.1,8592140,8056183,535957,6.2
1990,May,68.4,64.2,8606931,8069925,537006,6.2
1990,Jun,68.5,64.2,8618308,8079922,538386,6.2
1990,Jul,68.6,64.3,8628601,8087867,540734,6.3
1990,Aug,68.5,64.2,8639902,8094973,544929,6.3
1990,Sep,68.5,64.2,8651162,8100599,550563,6.4
1990,Oct,68.5,64.1,8660931,8103614,557317,6.4
1990,Nov,68.4,64,8670233,8105688,564545,6.5
1990,Dec,68.4,63.9,8679857,8108364,571493,6.6
1991,Jan,68.4,63.8,8690060,8111414,578646,6.7
1991,Feb,68.4,63.8,8702207,8116452,585755,6.7
1991,Mar,68.4,63.8,8715080,8123665,591415,6.8
1991,Apr,68.4,63.7,8727678,8132922,594756,6.8
1991,May,68.4,63.7,8740588,8144048,596540,6.8
1991,Jun,68.4,63.7,8754825,8156673,598152,6.8
1991,Jul,68.4,63.7,8769323,8169147,600176,6.8
1991,Aug,68.4,63.7,8784865,8180166,604699,6.9
1991,Sep,68.5,63.7,8803796,8189899,613897,7
1991,Oct,68.5,63.7,8825539,8198148,627391,7.1
1991,Nov,68.6,63.6,8848136,8205370,642766,7.3
1991,Dec,68.7,63.6,8869946,8212912,657034,7.4
1992,Jan,68.8,63.6,8891705,8222987,668718,7.5
1992,Feb,68.9,63.6,8914515,8236370,678145,7.6
1992,Mar,69,63.7,8939715,8254338,685377,7.7
1992,Apr,69.1,63.8,8966875,8276182,690693,7.7
1992,May,69.2,63.8,8991923,8298164,693759,7.7
1992,Jun,69.2,63.9,9012246,8317784,694462,7.7
1992,Jul,69.2,63.9,9028300,8334457,693843,7.7
1992,Aug,69.2,63.9,9040671,8348375,692296,7.7
1992,Sep,69.2,63.9,9050234,8360011,690223,7.6
1992,Oct,69.1,63.8,9059658,8371358,688300,7.6
1992,Nov,69.1,63.8,9069412,8382518,686894,7.6
1992,Dec,69,63.8,9079491,8394296,685195,7.5
1993,Jan,69,63.8,9090333,8408770,681563,7.5
1993,Feb,69,63.9,9102130,8426484,675646,7.4
1993,Mar,69,63.9,9116466,8447741,668725,7.3
1993,Apr,69,64,9133901,8472232,661669,7.2
1993,May,69.1,64.1,9154528,8498215,656313,7.2
1993,Jun,69.1,64.2,9177544,8523613,653931,7.1
1993,Jul,69.2,64.3,9199698,8546565,653133,7.1
1993,Aug,69.2,64.3,9219355,8567153,652202,7.1
1993,Sep,69.2,64.3,9238054,8587507,650547,7
1993,Oct,69.2,64.4,9257367,8608603,648764,7
1993,Nov,69.3,64.4,9278286,8630206,648080,7
1993,Dec,69.3,64.5,9300743,8652603,648140,7
1994,Jan,69.4,64.5,9322445,8675074,647371,6.9
1994,Feb,69.4,64.6,9340297,8695954,644343,6.9
1994,Mar,69.4,64.6,9353175,8713907,639268,6.8
1994,Apr,69.3,64.7,9362455,8729666,632789,6.8
1994,May,69.3,64.7,9371442,8746267,625175,6.7
1994,Jun,69.3,64.7,9382844,8766113,616731,6.6
1994,Jul,69.3,64.8,9398705,8790544,608161,6.5
1994,Aug,69.3,64.9,9418583,8818901,599682,6.4
1994,Sep,69.3,65,9439746,8849295,590451,6.3
1994,Oct,69.4,65.1,9459029,8880061,578968,6.1
1994,Nov,69.4,65.2,9476550,8910047,566503,6
1994,Dec,69.4,65.3,9492061,8935454,556607,5.9
1995,Jan,69.4,65.4,9504877,8952868,552009,5.8
1995,Feb,69.4,65.3,9516781,8963533,553248,5.8
1995,Mar,69.4,65.3,9529224,8969916,559308,5.9
1995,Apr,69.3,65.2,9542504,8974183,568321,6
1995,May,69.4,65.2,9557531,8979518,578013,6
1995,Jun,69.4,65.1,9574102,8987870,586232,6.1
1995,Jul,69.4,65.1,9591059,8999216,591843,6.2
1995,Aug,69.4,65.1,9606369,9011574,594795,6.2
1995,Sep,69.3,65.1,9618449,9022864,595585,6.2
1995,Oct,69.3,65,9627113,9032047,595066,6.2
1995,Nov,69.2,65,9632220,9039498,592722,6.2
1995,Dec,69.2,64.9,9635664,9046884,588780,6.1
1996,Jan,69.1,64.9,9640810,9056792,584018,6.1
1996,Feb,69.1,64.9,9649363,9070647,578716,6
1996,Mar,69.1,65,9661402,9088839,572563,5.9
1996,Apr,69,65,9675564,9110611,564953,5.8
1996,May,69.1,65.1,9690106,9134473,555633,5.7
1996,Jun,69.1,65.2,9705040,9159075,545965,5.6
1996,Jul,69.1,65.2,9721533,9183484,538049,5.5
1996,Aug,69.1,65.3,9740171,9206858,533313,5.5
1996,Sep,69.1,65.3,9759857,9227004,532853,5.5
1996,Oct,69.1,65.3,9779883,9242397,537486,5.5
1996,Nov,69.1,65.3,9799683,9254285,545398,5.6
1996,Dec,69.1,65.2,9818710,9265933,552777,5.6
1997,Jan,69.1,65.2,9836787,9279891,556896,5.7
1997,Feb,69.2,65.3,9854163,9297416,556747,5.6
1997,Mar,69.2,65.3,9871623,9319393,552230,5.6
1997,Apr,69.2,65.4,9890605,9345189,545416,5.5
1997,May,69.2,65.5,9909452,9371279,538173,5.4
1997,Jun,69.2,65.5,9925891,9395133,530758,5.3
1997,Jul,69.2,65.6,9939510,9416480,523030,5.3
1997,Aug,69.2,65.6,9951222,9435322,515900,5.2
1997,Sep,69.1,65.6,9961428,9452472,508956,5.1
1997,Oct,69.1,65.6,9970657,9468493,502164,5
1997,Nov,69,65.6,9979329,9483181,496148,5
1997,Dec,69,65.6,9988808,9497559,491249,4.9
1998,Jan,68.9,65.6,10000067,9512374,487693,4.9
1998,Feb,68.9,65.6,10013713,9527942,485771,4.9
1998,Mar,68.9,65.6,10029251,9543375,485876,4.8
1998,Apr,68.9,65.6,10047147,9559069,488078,4.9
1998,May,69,65.6,10068283,9575908,492375,4.9
1998,Jun,69,65.6,10091366,9593557,497809,4.9
1998,Jul,69,65.6,10113762,9611232,502530,5
1998,Aug,69.1,65.6,10133933,9629835,504098,5
1998,Sep,69.1,65.6,10151338,9649373,501965,4.9
1998,Oct,69,65.7,10164504,9668810,495694,4.9
1998,Nov,69,65.7,10172690,9686070,486620,4.8
1998,Dec,68.9,65.7,10177601,9699479,478122,4.7
1999,Jan,68.8,65.6,10181755,9709708,472047,4.6
1999,Feb,68.8,65.6,10188154,9718427,469727,4.6
1999,Mar,68.7,65.6,10198320,9727525,470795,4.6
1999,Apr,68.7,65.5,10211072,9737626,473446,4.6
1999,May,68.7,65.5,10224664,9748276,476388,4.7
1999,Jun,68.7,65.5,10238515,9759528,478987,4.7
1999,Jul,68.6,65.4,10251764,9770682,481082,4.7
1999,Aug,68.6,65.4,10263929,9781805,482124,4.7
1999,Sep,68.6,65.4,10276684,9794376,482308,4.7
1999,Oct,68.6,65.3,10292450,9809527,482923,4.7
1999,Nov,68.6,65.4,10312387,9828720,483667,4.7
1999,Dec,68.6,65.4,10333611,9850442,483169,4.7
2000,Jan,68.6,65.5,10352120,9871379,480741,4.6
2000,Feb,68.6,65.5,10363975,9888676,475299,4.6
2000,Mar,68.6,65.5,10368180,9900637,467543,4.5
2000,Apr,68.5,65.5,10366277,9907234,459043,4.4
2000,May,68.4,65.4,10360899,9910437,450462,4.3
2000,Jun,68.2,65.3,10355498,9912411,443087,4.3
2000,Jul,68.1,65.2,10353750,9916553,437197,4.2
2000,Aug,68,65.2,10359140,9926692,432448,4.2
2000,Sep,68,65.2,10371939,9943956,427983,4.1
2000,Oct,68,65.2,10390780,9967589,423191,4.1
2000,Nov,68,65.3,10413547,9993455,420092,4
2000,Dec,68.1,65.3,10437506,10016600,420906,4
2001,Jan,68.1,65.3,10459411,10032761,426650,4.1
2001,Feb,68.1,65.3,10477511,10040042,437469,4.2
2001,Mar,68.1,65.2,10490731,10038768,451963,4.3
2001,Apr,68,65,10499251,10030823,468428,4.5
2001,May,68,64.8,10506482,10020588,485894,4.6
2001,Jun,67.9,64.7,10514918,10010984,503934,4.8
2001,Jul,67.9,64.5,10527073,10003746,523327,5
2001,Aug,67.9,64.4,10542194,9996904,545290,5.2
2001,Sep,67.9,64.2,10559372,9989990,569382,5.4
2001,Oct,67.9,64.1,10578152,9984676,593476,5.6
2001,Nov,67.9,64,10596903,9981729,615174,5.8
2001,Dec,67.9,63.9,10616118,9982878,633240,6
2002,Jan,67.9,63.8,10636509,9988954,647555,6.1
2002,Feb,68,63.8,10657551,9998790,658761,6.2
2002,Mar,68,63.8,10678637,10010910,667727,6.3
2002,Apr,68.1,63.8,10701117,10026219,674898,6.3
2002,May,68.1,63.8,10725163,10044638,680525,6.3
2002,Jun,68.2,63.8,10749742,10065271,684471,6.4
2002,Jul,68.2,63.9,10771961,10084917,687044,6.4
2002,Aug,68.2,63.9,10790555,10101364,689191,6.4
2002,Sep,68.2,63.8,10805966,10113207,692759,6.4
2002,Oct,68.2,63.8,10817664,10118977,698687,6.5
2002,Nov,68.1,63.7,10827973,10121758,706215,6.5
2002,Dec,68.1,63.6,10838197,10124547,713650,6.6
2003,Jan,68.1,63.6,10851387,10130205,721182,6.6
2003,Feb,68.1,63.6,10869345,10140465,728880,6.7
2003,Mar,68.2,63.6,10889972,10153815,736157,6.8
2003,Apr,68.2,63.6,10908563,10165816,742747,6.8
2003,May,68.2,63.5,10920925,10172696,748229,6.9
2003,Jun,68.1,63.5,10927376,10176027,751349,6.9
2003,Jul,68.1,63.4,10929180,10179526,749654,6.9
2003,Aug,68,63.3,10928430,10186025,742405,6.8
2003,Sep,67.8,63.3,10927537,10197642,729895,6.7
2003,Oct,67.7,63.3,10929415,10214308,715107,6.5
2003,Nov,67.7,63.3,10935047,10233481,701566,6.4
2003,Dec,67.6,63.4,10943081,10252239,690842,6.3
2004,Jan,67.6,63.4,10950759,10268166,682593,6.2
2004,Feb,67.6,63.4,10956841,10280897,675944,6.2
2004,Mar,67.5,63.4,10963502,10293104,670398,6.1
2004,Apr,67.5,63.4,10970651,10306589,664062,6.1
2004,May,67.4,63.4,10977679,10321473,656206,6
2004,Jun,67.4,63.4,10984363,10336438,647925,5.9
2004,Jul,67.3,63.4,10991710,10350156,641554,5.8
2004,Aug,67.2,63.3,10999691,10361739,637952,5.8
2004,Sep,67.2,63.3,11007490,10370374,637116,5.8
2004,Oct,67.1,63.2,11014707,10376614,638093,5.8
2004,Nov,67.1,63.2,11020879,10382423,638456,5.8
2004,Dec,67,63.1,11028247,10390753,637494,5.8
2005,Jan,67,63.1,11037100,10403406,633694,5.7
2005,Feb,66.9,63.1,11045648,10419649,625999,5.7
2005,Mar,66.9,63.2,11053577,10438205,615372,5.6
2005,Apr,66.9,63.2,11063579,10459086,604493,5.5
2005,May,66.9,63.3,11078994,10483667,595327,5.4
2005,Jun,66.9,63.3,11100075,10510835,589240,5.3
2005,Jul,66.9,63.4,11125453,10537929,587524,5.3
2005,Aug,67,63.4,11152336,10563342,588994,5.3
2005,Sep,66.8,63.2,11177729,10586350,591379,5.3
2005,Oct,66.9,63.4,11199663,10607524,592139,5.3
2005,Nov,67,63.5,11217536,10626919,590617,5.3
2005,Dec,67,63.5,11231225,10644156,587069,5.2
2006,Jan,67,63.5,11243681,10660955,582726,5.2
2006,Feb,67,63.5,11258185,10678976,579209,5.1
2006,Mar,66.9,63.5,11275668,10698620,577048,5.1
2006,Apr,66.8,63.4,11294545,10718758,575787,5.1
2006,May,66.7,63.4,11312321,10738395,573926,5.1
2006,Jun,66.6,63.3,11327299,10757391,569908,5
2006,Jul,66.5,63.2,11340413,10778246,562167,5
2006,Aug,66.5,63.2,11353498,10802081,551417,4.9
2006,Sep,66.4,63.3,11367062,10827205,539857,4.7
2006,Oct,66.4,63.3,11380249,10852087,528162,4.6
2006,Nov,66.3,63.3,11391430,10874236,517194,4.5
2006,Dec,66.3,63.3,11397862,10890661,507201,4.4
2007,Jan,66.1,63.3,11398544,10900033,498511,4.4
2007,Feb,66,63.2,11396233,10904607,491626,4.3
2007,Mar,65.9,63.1,11392933,10906835,486098,4.3
2007,Apr,65.8,63,11391893,10909749,482144,4.2
2007,May,65.7,62.9,11395472,10915098,480374,4.2
2007,Jun,65.6,62.9,11403913,10923517,480396,4.2
2007,Jul,65.6,62.8,11417028,10934650,482378,4.2
2007,Aug,65.6,62.8,11434980,10948390,486590,4.3
2007,Sep,65.6,62.8,11456726,10965668,491058,4.3
2007,Oct,65.6,62.8,11479835,10985136,494699,4.3
2007,Nov,65.6,62.8,11502507,11006263,496244,4.3
2007,Dec,65.7,62.8,11524334,11028715,495619,4.3
2008,Jan,65.7,62.8,11544197,11049576,494621,4.3
2008,Feb,65.7,62.8,11562088,11067372,494716,4.3
2008,Mar,65.7,62.8,11580523,11082153,498370,4.3
2008,Apr,65.7,62.8,11601493,11094376,507117,4.4
2008,May,65.7,62.8,11626382,11105401,520981,4.5
2008,Jun,65.8,62.7,11655723,11116564,539159,4.6
2008,Jul,65.8,62.7,11686033,11126971,559062,4.8
2008,Aug,65.9,62.6,11713184,11134279,578905,4.9
2008,Sep,65.9,62.5,11735105,11135112,599993,5.1
2008,Oct,65.8,62.3,11751292,11126900,624392,5.3
2008,Nov,65.8,62.1,11761609,11108817,652792,5.6
2008,Dec,65.7,61.9,11767135,11083429,683706,5.8
2009,Jan,65.6,61.6,11769634,11055467,714167,6.1
2009,Feb,65.5,61.4,11771891,11030382,741509,6.3
2009,Mar,65.5,61.2,11776375,11014244,762131,6.5
2009,Apr,65.4,61.1,11782809,11008811,773998,6.6
2009,May,66,61,11909643,11009038,900605,7.6
2009,Jun,66.2,60.9,11970340,11010114,960226,8
2009,Jul,66.2,60.8,11994007,11008166,985841,8.2
2009,Aug,66.2,60.7,11997127,11002281,994846,8.3
2009,Sep,66,60.5,11992696,10996372,996324,8.3
2009,Oct,65.9,60.4,11990132,10994996,995136,8.3
2009,Nov,65.9,60.4,11999329,11004318,995011,8.3
2009,Dec,65.9,60.4,12026349,11028565,997784,8.3
2010,Jan,66,60.6,12068751,11067039,1001712,8.3
2010,Feb,66.2,60.7,12116512,11112513,1003999,8.3
2010,Mar,66.4,60.9,12160592,11157088,1003504,8.3
2010,Apr,65.8,60.4,12196433,11196606,999827,8.2
2010,May,65.8,60.5,12222758,11230124,992634,8.1
2010,Jun,65.8,60.5,12241226,11256000,985226,8
2010,Jul,65.8,60.5,12256847,11274789,982058,8
2010,Aug,65.8,60.5,12275032,11290591,984441,8
2010,Sep,65.8,60.5,12297212,11306452,990760,8.1
2010,Oct,65.8,60.5,12323904,11326471,997433,8.1
2010,Nov,65.9,60.5,12351634,11350972,1000662,8.1
2010,Dec,65.9,60.6,12376187,11377594,998593,8.1
2011,Jan,65.9,60.6,12398361,11405419,992942,8
2011,Feb,65.9,60.7,12418190,11431874,986316,7.9
2011,Mar,65.9,60.7,12434400,11453932,980468,7.9
2011,Apr,65.9,60.7,12448436,11470598,977838,7.9
2011,May,65.9,60.7,12464746,11484860,979886,7.9
2011,Jun,65.9,60.7,12485494,11501815,983679,7.9
2011,Jul,65.9,60.7,12510889,11526050,984839,7.9
2011,Aug,66,60.8,12538173,11557468,980705,7.8
2011,Sep,66,60.9,12562867,11592874,969993,7.7
2011,Oct,66,61,12582374,11628674,953700,7.6
2011,Nov,65.9,61,12594608,11660707,933901,7.4
2011,Dec,65.8,61.1,12599720,11686379,913341,7.2
2012,Jan,65.7,61.1,12600830,11705732,895098,7.1
2012,Feb,65.7,61.1,12603733,11721887,881846,7
2012,Mar,65.6,61,12611236,11736127,875109,6.9
2012,Apr,65.6,61,12621391,11749382,872009,6.9
2012,May,65.5,61,12634585,11766133,868452,6.9
2012,Jun,65.5,61,12651081,11789580,861501,6.8
2012,Jul,65.5,61.1,12670049,11820135,849914,6.7
2012,Aug,65.5,61.2,12691669,11854807,836862,6.6
2012,Sep,65.5,61.3,12715945,11888879,827066,6.5
2012,Oct,65.5,61.3,12738355,11915952,822403,6.5
2012,Nov,65.5,61.3,12755964,11932919,823045,6.5
2012,Dec,65.5,61.2,12768962,11941642,827320,6.5
2013,Jan,65.5,61.2,12782095,11950350,831745,6.5
2013,Feb,65.4,61.1,12791417,11955951,835466,6.5
2013,Mar,65.4,61.1,12804276,11969681,834595,6.5
2013,Apr,65.4,61.2,12823913,11994866,829047,6.5
2013,May,65.4,61.2,12846262,12024923,821339,6.4
2013,Jun,65.4,61.3,12866183,12052275,813908,6.3
2013,Jul,65.4,61.3,12881306,12073900,807406,6.3
2013,Aug,65.3,61.3,12889379,12090790,798589,6.2
2013,Sep,65.2,61.3,12892798,12106935,785863,6.1
2013,Oct,65.1,61.2,12899050,12126701,772349,6
2013,Nov,65.1,61.3,12912799,12153454,759345,5.9
2013,Dec,65.1,61.3,12932783,12186304,746479,5.8
2014,Jan,65.1,61.5,12965427,12232666,732761,5.7
2014,Feb,65.1,61.5,12985475,12268181,717294,5.5
2014,Mar,65.1,61.6,13003115,12299831,703284,5.4
2014,Apr,65.1,61.6,13016630,12324725,691905,5.3
2014,May,65,61.6,13027345,12345743,681602,5.2
2014,Jun,65,61.6,13039482,12367837,671645,5.2
2014,Jul,64.9,61.6,13052806,12391017,661789,5.1
2014,Aug,64.9,61.6,13066919,12414967,651952,5
2014,Sep,64.8,61.6,13079290,12438299,640991,4.9
2014,Oct,64.7,61.6,13084576,12457796,626780,4.8
2014,Nov,64.6,61.6,13080363,12470156,610207,4.7
2014,Dec,64.4,61.5,13071141,12475844,595297,4.6
2015,Jan,64.2,61.4,13053525,12469536,583989,4.5
2015,Feb,64.1,61.3,13048430,12469746,578684,4.4
2015,Mar,64,61.2,13049082,12472470,576612,4.4
2015,Apr,63.9,61.1,13054746,12479211,575535,4.4
2015,May,63.8,61,13062607,12487773,574834,4.4
2015,Jun,63.8,61,13069936,12495242,574694,4.4
2015,Jul,63.7,60.9,13078000,12501778,576222,4.4
2015,Aug,63.6,60.8,13088345,12508795,579550,4.4
2015,Sep,63.6,60.8,13101981,12519355,582626,4.4
2015,Oct,63.6,60.8,13122196,12537645,584551,4.5
2015,Nov,63.6,60.8,13149639,12564036,585603,4.5
2015,Dec,63.7,60.8,13179976,12594665,585311,4.4
2016,Jan,63.7,60.9,13208828,12624562,584266,4.4
2016,Feb,63.7,60.9,13234764,12649925,584839,4.4
2016,Mar,63.7,60.9,13257970,12669432,588538,4.4
2016,Apr,63.8,60.9,13280901,12684335,596566,4.5
2016,May,63.8,60.9,13305802,12697623,608179,4.6
2016,Jun,63.8,60.8,13331528,12711478,620050,4.7
2016,Jul,63.8,60.8,13356210,12726964,629246,4.7
2016,Aug,63.8,60.8,13378885,12743432,635453,4.7
2016,Sep,63.8,60.8,13399340,12759137,640203,4.8
2016,Oct,63.8,60.8,13416647,12773301,643346,4.8
2016,Nov,63.8,60.7,13432470,12788698,643772,4.8
2016,Dec,63.8,60.8,13449886,12808057,641829,4.8
2017,Jan,63.8,60.8,13469939,12832003,637936,4.7
2017,Feb,63.8,60.8,13490852,12860135,630717,4.7
2017,Mar,63.8,60.9,13509998,12889646,620352,4.6
2017,Apr,63.8,61,13527910,12919986,607924,4.5
2017,May,63.8,61,13545404,12951366,594038,4.4
2017,Jun,63.8,61.1,13563216,12982307,580909,4.3
2017,Jul,63.8,61.2,13582350,13011793,570557,4.2
2017,Aug,63.8,61.2,13601714,13038893,562821,4.1
2017,Sep,63.8,61.2,13621164,13063996,557168,4.1
2017,Oct,63.9,61.3,13641289,13087950,553339,4.1
2017,Nov,63.9,61.3,13661966,13110303,551663,4
2017,Dec,63.9,61.3,13683655,13132506,551149,4
2018,Jan,63.9,61.4,13707892,13156374,551518,4
2018,Feb,64,61.4,13735386,13182948,552438,4
2018,Mar,64,61.5,13762997,13211042,551955,4
2018,Apr,64.1,61.5,13784494,13236243,548251,4
2018,May,64,61.5,13798149,13256169,541980,3.9
2018,Jun,64,61.5,13807325,13273403,533922,3.9
2018,Jul,64,61.5,13815834,13290921,524913,3.8
2018,Aug,63.9,61.5,13829344,13311213,518131,3.7
2018,Sep,63.9,61.6,13850222,13334935,515287,3.7
2018,Oct,64,61.6,13876594,13360885,515709,3.7
2018,Nov,64,61.6,13903768,13386988,516780,3.7
2018,Dec,64,61.7,13925197,13409628,515569,3.7
2019,Jan,64,61.7,13936827,13426550,510277,3.7
2019,Feb,63.9,61.6,13939304,13437974,501330,3.6
2019,Mar,63.9,61.6,13939677,13447760,491917,3.5
2019,Apr,63.8,61.6,13946357,13461899,484458,3.5
2019,May,63.8,61.6,13964638,13483946,480692,3.4
2019,Jun,63.9,61.7,13996248,13514401,481847,3.4
2019,Jul,64,61.8,14042579,13555554,487025,3.5
2019,Aug,64.1,61.9,14090993,13598543,492450,3.5
2019,Sep,64.2,62,14133202,13637428,495774,3.5
2019,Oct,64.2,62,14160862,13663754,497108,3.5
2019,Nov,64.2,61.9,14161219,13664882,496337,3.5
2019,Dec,64.1,61.8,14155916,13660124,495792,3.5
2020,Jan,64.1,61.9,14180789,13686397,494392,3.5
2020,Feb,64.1,61.9,14199564,13707110,492454,3.5
2020,Mar,63.1,59.9,14004479,13288652,715827,5.1
2020,Apr,58.4,50.5,12960683,11216661,1744022,13.5
2020,May,60.7,52.8,13498250,11745046,1753204,13
2020,Jun,61.9,56.8,13794279,12639427,1154852,8.4
2020,Jul,62,57,13834694,12721089,1113605,8
2020,Aug,64.4,60,14386708,13405271,981437,6.8
2020,Sep,63.6,58.3,14214922,13029836,1185086,8.3
