Year,Period,labor force participation rate,employment-population ratio,labor force,employment,unemployment,unemployment rate
1976,Jan,65.9,62,2328545,2190847,137698,5.9
1976,Feb,65.7,61.8,2327900,2190461,137439,5.9
1976,Mar,65.6,61.7,2328207,2191511,136696,5.9
1976,Apr,65.5,61.7,2330919,2195231,135688,5.8
1976,May,65.5,61.7,2334945,2199661,135284,5.8
1976,Jun,65.4,61.7,2339651,2204049,135602,5.8
1976,Jul,65.4,61.6,2343598,2207139,136459,5.8
1976,Aug,65.4,61.5,2346485,2209333,137152,5.8
1976,Sep,65.3,61.5,2348914,2211644,137270,5.8
1976,Oct,65.2,61.4,2351902,2214527,137375,5.8
1976,Nov,65.2,61.4,2356042,2218468,137574,5.8
1976,Dec,65.2,61.4,2361415,2223892,137523,5.8
1977,Jan,65.3,61.5,2368365,2231138,137227,5.8
1977,Feb,65.4,61.6,2376572,2239812,136760,5.8
1977,Mar,65.5,61.7,2384337,2248658,135679,5.7
1977,Apr,65.5,61.9,2390572,2256965,133607,5.6
1977,May,65.5,61.9,2395358,2264422,130936,5.5
1977,Jun,65.5,62,2399722,2271131,128591,5.4
1977,Jul,65.5,62,2405066,2277813,127253,5.3
1977,Aug,65.6,62.1,2412419,2285198,127221,5.3
1977,Sep,65.7,62.2,2421483,2293372,128111,5.3
1977,Oct,65.8,62.3,2430715,2301538,129177,5.3
1977,Nov,65.9,62.4,2439240,2309004,130236,5.3
1977,Dec,66,62.4,2446652,2315403,131249,5.4
1978,Jan,66,62.5,2453621,2321822,131799,5.4
1978,Feb,66.1,62.5,2461035,2329311,131724,5.4
1978,Mar,66.2,62.7,2469578,2338188,131390,5.3
1978,Apr,66.3,62.8,2479234,2347895,131339,5.3
1978,May,66.4,62.9,2489029,2357436,131593,5.3
1978,Jun,66.5,63,2497402,2365680,131722,5.3
1978,Jul,66.5,63,2503172,2371482,131690,5.3
1978,Aug,66.5,63,2506516,2374757,131759,5.3
1978,Sep,66.5,63,2508691,2376816,131875,5.3
1978,Oct,66.5,63,2511549,2379703,131846,5.2
1978,Nov,66.5,63,2515652,2384215,131437,5.2
1978,Dec,66.5,63,2519926,2389378,130548,5.2
1979,Jan,66.5,63.1,2522789,2393658,129131,5.1
1979,Feb,66.4,63.1,2523714,2396705,127009,5
1979,Mar,66.3,63,2523307,2399028,124279,4.9
1979,Apr,66.2,63,2522571,2401169,121402,4.8
1979,May,66.1,63,2523193,2404161,119032,4.7
1979,Jun,66.1,63,2526095,2408316,117779,4.7
1979,Jul,66.1,63.1,2531563,2414115,117448,4.6
1979,Aug,66.2,63.2,2539060,2421315,117745,4.6
1979,Sep,66.4,63.3,2546941,2428755,118186,4.6
1979,Oct,66.4,63.4,2553107,2435254,117853,4.6
1979,Nov,66.4,63.4,2556456,2439933,116523,4.6
1979,Dec,66.4,63.4,2557218,2442148,115070,4.5
1980,Jan,66.2,63.3,2555905,2441154,114751,4.5
1980,Feb,66.1,63.1,2553641,2436777,116864,4.6
1980,Mar,66,62.8,2551823,2429881,121942,4.8
1980,Apr,65.9,62.5,2551419,2422424,128995,5.1
1980,May,65.8,62.3,2552681,2416446,136235,5.3
1980,Jun,65.8,62.1,2555824,2413978,141846,5.5
1980,Jul,65.8,62.1,2559825,2415524,144301,5.6
1980,Aug,65.8,62.1,2563299,2420229,143070,5.6
1980,Sep,65.7,62.2,2566104,2426603,139501,5.4
1980,Oct,65.7,62.2,2568839,2432785,136054,5.3
1980,Nov,65.7,62.3,2572633,2438281,134352,5.2
1980,Dec,65.8,62.3,2578928,2443944,134984,5.2
1981,Jan,65.9,62.4,2587701,2449589,138112,5.3
1981,Feb,66,62.4,2596989,2454307,142682,5.5
1981,Mar,66.1,62.4,2605167,2458117,147050,5.6
1981,Apr,66.2,62.4,2610678,2460415,150263,5.8
1981,May,66.1,62.3,2612572,2460443,152129,5.8
1981,Jun,66,62.1,2611629,2458490,153139,5.9
1981,Jul,65.8,61.9,2609567,2454984,154583,5.9
1981,Aug,65.7,61.8,2607863,2450582,157281,6
1981,Sep,65.6,61.6,2607510,2446256,161254,6.2
1981,Oct,65.6,61.4,2609243,2442725,166518,6.4
1981,Nov,65.6,61.3,2612396,2439634,172762,6.6
1981,Dec,65.6,61.1,2616411,2437326,179085,6.8
1982,Jan,65.7,61.1,2621438,2437163,184275,7
1982,Feb,65.7,61,2627283,2439291,187992,7.2
1982,Mar,65.8,61,2632792,2442350,190442,7.2
1982,Apr,65.8,61,2637700,2445880,191820,7.3
1982,May,65.9,61.1,2642248,2449658,192590,7.3
1982,Jun,65.9,61.1,2646195,2452855,193340,7.3
1982,Jul,65.9,61,2650308,2455370,194938,7.4
1982,Aug,66,61,2655900,2457737,198163,7.5
1982,Sep,66.1,61,2663275,2460428,202847,7.6
1982,Oct,66.2,61,2671586,2463901,207685,7.8
1982,Nov,66.3,61.1,2680003,2468732,211271,7.9
1982,Dec,66.4,61.1,2686503,2474205,212298,7.9
1983,Jan,66.4,61.2,2690087,2479873,210214,7.8
1983,Feb,66.3,61.3,2692004,2487087,204917,7.6
1983,Mar,66.3,61.5,2694133,2496871,197262,7.3
1983,Apr,66.3,61.7,2698497,2509506,188991,7
1983,May,66.4,62,2705882,2524294,181588,6.7
1983,Jun,66.6,62.3,2715738,2540120,175618,6.5
1983,Jul,66.8,62.6,2726388,2555775,170613,6.3
1983,Aug,66.9,62.8,2735602,2569801,165801,6.1
1983,Sep,67,63,2742486,2581689,160797,5.9
1983,Oct,67,63.2,2747448,2592060,155388,5.7
1983,Nov,67,63.3,2751534,2601729,149805,5.4
1983,Dec,67,63.5,2756905,2611981,144924,5.3
1984,Jan,67.1,63.7,2765305,2623993,141312,5.1
1984,Feb,67.3,63.9,2776674,2637383,139291,5
1984,Mar,67.5,64.1,2789627,2650680,138947,5
1984,Apr,67.7,64.3,2801778,2662247,139531,5
1984,May,67.8,64.4,2811941,2671438,140503,5
1984,Jun,67.9,64.5,2819891,2678318,141573,5
1984,Jul,68,64.5,2825913,2683290,142623,5
1984,Aug,68,64.6,2830963,2687234,143729,5.1
1984,Sep,68.1,64.6,2835695,2690655,145040,5.1
1984,Oct,68.1,64.6,2841002,2694319,146683,5.2
1984,Nov,68.2,64.6,2847614,2699032,148582,5.2
1984,Dec,68.3,64.7,2854864,2704426,150438,5.3
1985,Jan,68.4,64.7,2860775,2708675,152100,5.3
1985,Feb,68.4,64.7,2864044,2710010,154034,5.4
1985,Mar,68.3,64.6,2864518,2708133,156385,5.5
1985,Apr,68.2,64.4,2863040,2704008,159032,5.6
1985,May,68,64.2,2860749,2699290,161459,5.6
1985,Jun,67.9,64.1,2858827,2695897,162930,5.7
1985,Jul,67.8,64,2858197,2695104,163093,5.7
1985,Aug,67.8,63.9,2859433,2697904,161529,5.6
1985,Sep,67.7,63.9,2862077,2703772,158305,5.5
1985,Oct,67.6,64,2864949,2710655,154294,5.4
1985,Nov,67.6,64,2867110,2716573,150537,5.3
1985,Dec,67.5,64,2868354,2720520,147834,5.2
1986,Jan,67.4,64,2869914,2723281,146633,5.1
1986,Feb,67.4,63.9,2873454,2726934,146520,5.1
1986,Mar,67.4,64,2879582,2732916,146666,5.1
1986,Apr,67.5,64.1,2888250,2741398,146852,5.1
1986,May,67.6,64.2,2898522,2751591,146931,5.1
1986,Jun,67.7,64.3,2909636,2762560,147076,5.1
1986,Jul,67.9,64.5,2920677,2773420,147257,5
1986,Aug,68,64.6,2930592,2783108,147484,5
1986,Sep,68.1,64.6,2939004,2791427,147577,5
1986,Oct,68.1,64.7,2946198,2798980,147218,5
1986,Nov,68.1,64.7,2952375,2805955,146420,5
1986,Dec,68.1,64.8,2958913,2813609,145304,4.9
1987,Jan,68.2,64.9,2966196,2822324,143872,4.9
1987,Feb,68.2,65,2973373,2831540,141833,4.8
1987,Mar,68.3,65.1,2980640,2841415,139225,4.7
1987,Apr,68.3,65.2,2987931,2851944,135987,4.6
1987,May,68.3,65.3,2994786,2862637,132149,4.4
1987,Jun,68.3,65.4,3000828,2872793,128035,4.3
1987,Jul,68.3,65.5,3006399,2882251,124148,4.1
1987,Aug,68.4,65.6,3012393,2891265,121128,4
1987,Sep,68.4,65.7,3019812,2900552,119260,3.9
1987,Oct,68.5,65.8,3028511,2910143,118368,3.9
1987,Nov,68.6,65.9,3037986,2920116,117870,3.9
1987,Dec,68.7,66,3047011,2929467,117544,3.9
1988,Jan,68.7,66.1,3054715,2937397,117318,3.8
1988,Feb,68.8,66.1,3061386,2943971,117415,3.8
1988,Mar,68.8,66.1,3066894,2948838,118056,3.8
1988,Apr,68.8,66.1,3071576,2952363,119213,3.9
1988,May,68.8,66.1,3076240,2955428,120812,3.9
1988,Jun,68.8,66,3081230,2958624,122606,4
1988,Jul,68.8,66,3086252,2962029,124223,4
1988,Aug,68.8,66,3090841,2965575,125266,4.1
1988,Sep,68.8,66,3094761,2969314,125447,4.1
1988,Oct,68.8,66,3098021,2973566,124455,4
1988,Nov,68.8,66.1,3101112,2978606,122506,4
1988,Dec,68.8,66.1,3104481,2984377,120104,3.9
1989,Jan,68.8,66.2,3109002,2991010,117992,3.8
1989,Feb,68.9,66.3,3115015,2998017,116998,3.8
1989,Mar,69,66.4,3122765,3005610,117155,3.8
1989,Apr,69.1,66.5,3131741,3013541,118200,3.8
1989,May,69.2,66.6,3141034,3021154,119880,3.8
1989,Jun,69.3,66.7,3150143,3028251,121892,3.9
1989,Jul,69.4,66.7,3158362,3034479,123883,3.9
1989,Aug,69.5,66.8,3165612,3040022,125590,4
1989,Sep,69.6,66.8,3172338,3045582,126756,4
1989,Oct,69.7,66.9,3179602,3052453,127149,4
1989,Nov,69.8,67,3187536,3060811,126725,4
1989,Dec,69.9,67.1,3196039,3070269,125770,3.9
1990,Jan,69.2,66.6,3204724,3080123,124601,3.9
1990,Feb,69.3,66.7,3212907,3089238,123669,3.8
1990,Mar,69.4,66.8,3220412,3096440,123972,3.8
1990,Apr,69.5,66.8,3227642,3101378,126264,3.9
1990,May,69.6,66.8,3235517,3104912,130605,4
1990,Jun,69.7,66.8,3244138,3107509,136629,4.2
1990,Jul,69.9,66.8,3254087,3110187,143900,4.4
1990,Aug,70,66.8,3264974,3113262,151712,4.6
1990,Sep,70.2,66.7,3275232,3115611,159621,4.9
1990,Oct,70.3,66.7,3283956,3116204,167752,5.1
1990,Nov,70.4,66.6,3291601,3115914,175687,5.3
1990,Dec,70.4,66.5,3298456,3115700,182756,5.5
1991,Jan,70.5,66.5,3304541,3115788,188753,5.7
1991,Feb,70.6,66.4,3310647,3117365,193282,5.8
1991,Mar,70.6,66.5,3316308,3120475,195833,5.9
1991,Apr,70.7,66.5,3321602,3125054,196548,5.9
1991,May,70.7,66.5,3327233,3131273,195960,5.9
1991,Jun,70.8,66.7,3333805,3138949,194856,5.8
1991,Jul,70.9,66.8,3341068,3146978,194090,5.8
1991,Aug,70.9,66.8,3348932,3154386,194546,5.8
1991,Sep,71,66.9,3357796,3160829,196967,5.9
1991,Oct,71.1,66.9,3367041,3165527,201514,6
1991,Nov,71.2,66.9,3375860,3168316,207544,6.1
1991,Dec,71.3,66.8,3383643,3169906,213737,6.3
1992,Jan,71.4,66.8,3390464,3171579,218885,6.5
1992,Feb,71.5,66.8,3396406,3174101,222305,6.5
1992,Mar,71.5,66.8,3402217,3178530,223687,6.6
1992,Apr,71.5,66.8,3407609,3184485,223124,6.5
1992,May,71.5,66.9,3410804,3189808,220996,6.5
1992,Jun,71.4,66.9,3411006,3193145,217861,6.4
1992,Jul,71.3,66.8,3408813,3194363,214450,6.3
1992,Aug,71.1,66.7,3404738,3193695,211043,6.2
1992,Sep,70.9,66.6,3399102,3191774,207328,6.1
1992,Oct,70.6,66.4,3393104,3190114,202990,6
1992,Nov,70.4,66.3,3387220,3188827,198393,5.9
1992,Dec,70.2,66.2,3382082,3188088,193994,5.7
1993,Jan,70.1,66.1,3378552,3188752,189800,5.6
1993,Feb,70,66.1,3376784,3190736,186048,5.5
1993,Mar,69.9,66.1,3376956,3193839,183117,5.4
1993,Apr,69.8,66.1,3378618,3197656,180962,5.4
1993,May,69.8,66.1,3380749,3201185,179564,5.3
1993,Jun,69.7,66,3382100,3203534,178566,5.3
1993,Jul,69.6,66,3381303,3204228,177075,5.2
1993,Aug,69.5,65.9,3378982,3204142,174840,5.2
1993,Sep,69.4,65.8,3377428,3204987,172441,5.1
1993,Oct,69.3,65.8,3378018,3207369,170649,5.1
1993,Nov,69.3,65.8,3381318,3211144,170174,5
1993,Dec,69.3,65.8,3387370,3216386,170984,5
1994,Jan,69.4,65.9,3394765,3222338,172427,5.1
1994,Feb,69.5,65.9,3401254,3227729,173525,5.1
1994,Mar,69.5,66,3405452,3231803,173649,5.1
1994,Apr,69.5,65.9,3407810,3235227,172583,5.1
1994,May,69.5,66,3410327,3239865,170462,5
1994,Jun,69.5,66.1,3414821,3246997,167824,4.9
1994,Jul,69.6,66.2,3422597,3257130,165467,4.8
1994,Aug,69.7,66.4,3433267,3269598,163669,4.8
1994,Sep,69.9,66.6,3445238,3283243,161995,4.7
1994,Oct,70,66.8,3456934,3297258,159676,4.6
1994,Nov,70.1,67,3467404,3310762,156642,4.5
1994,Dec,70.2,67.1,3474822,3321048,153774,4.4
1995,Jan,70.2,67.1,3477784,3325813,151971,4.4
1995,Feb,70.1,67.1,3476917,3325455,151462,4.4
1995,Mar,70,66.9,3473146,3320996,152150,4.4
1995,Apr,69.8,66.7,3467285,3313583,153702,4.4
1995,May,69.6,66.5,3460886,3305287,155599,4.5
1995,Jun,69.4,66.2,3455196,3297824,157372,4.6
1995,Jul,69.2,66.1,3450232,3291725,158507,4.6
1995,Aug,69,65.9,3445173,3286146,159027,4.6
1995,Sep,68.8,65.6,3439224,3279997,159227,4.6
1995,Oct,68.6,65.4,3431794,3272666,159128,4.6
1995,Nov,68.3,65.2,3422800,3264539,158261,4.6
1995,Dec,68.1,64.9,3413457,3256934,156523,4.6
1996,Jan,67.8,64.8,3405903,3251535,154368,4.5
1996,Feb,67.7,64.7,3401919,3249208,152711,4.5
1996,Mar,67.6,64.6,3402166,3250303,151863,4.5
1996,Apr,67.6,64.6,3406020,3254467,151553,4.4
1996,May,67.7,64.7,3412222,3260716,151506,4.4
1996,Jun,67.7,64.7,3419393,3267909,151484,4.4
1996,Jul,67.8,64.8,3426421,3275045,151376,4.4
1996,Aug,67.8,64.8,3432364,3281220,151144,4.4
1996,Sep,67.8,64.8,3435785,3284873,150912,4.4
1996,Oct,67.7,64.7,3436502,3285231,151271,4.4
1996,Nov,67.6,64.6,3435564,3283325,152239,4.4
1996,Dec,67.5,64.5,3434466,3281278,153188,4.5
1997,Jan,67.5,64.4,3434357,3280845,153512,4.5
1997,Feb,67.4,64.5,3435804,3283191,152613,4.4
1997,Mar,67.4,64.5,3439301,3289122,150179,4.4
1997,Apr,67.5,64.6,3444586,3297920,146666,4.3
1997,May,67.5,64.7,3449329,3307182,142147,4.1
1997,Jun,67.5,64.8,3451876,3315314,136562,4
1997,Jul,67.4,64.9,3452464,3322216,130248,3.8
1997,Aug,67.4,65,3451739,3327926,123813,3.6
1997,Sep,67.3,65,3450558,3332788,117770,3.4
1997,Oct,67.2,65,3449647,3336814,112833,3.3
1997,Nov,67.1,65,3449112,3339881,109231,3.2
1997,Dec,67.1,65,3449675,3343058,106617,3.1
1998,Jan,67.1,65,3451827,3347208,104619,3
1998,Feb,67.1,65.1,3455443,3352495,102948,3
1998,Mar,67.1,65.2,3459764,3358255,101509,2.9
1998,Apr,67.2,65.2,3465028,3364833,100195,2.9
1998,May,67.3,65.3,3471967,3372549,99418,2.9
1998,Jun,67.4,65.4,3480122,3380511,99611,2.9
1998,Jul,67.5,65.5,3488540,3387916,100624,2.9
1998,Aug,67.5,65.6,3497129,3395462,101667,2.9
1998,Sep,67.6,65.7,3505791,3403714,102077,2.9
1998,Oct,67.7,65.7,3513688,3412471,101217,2.9
1998,Nov,67.7,65.8,3519703,3420318,99385,2.8
1998,Dec,67.7,65.8,3523026,3425530,97496,2.8
1999,Jan,67.6,65.8,3523793,3427886,95907,2.7
1999,Feb,67.6,65.8,3523192,3428289,94903,2.7
1999,Mar,67.5,65.7,3522878,3428219,94659,2.7
1999,Apr,67.5,65.6,3523869,3428728,95141,2.7
1999,May,67.4,65.6,3526539,3430464,96075,2.7
1999,Jun,67.4,65.6,3531351,3434196,97155,2.8
1999,Jul,67.5,65.6,3537636,3439396,98240,2.8
1999,Aug,67.5,65.6,3544581,3445453,99128,2.8
1999,Sep,67.6,65.7,3552136,3452506,99630,2.8
1999,Oct,67.6,65.8,3560300,3460792,99508,2.8
1999,Nov,67.7,65.9,3569500,3471087,98413,2.8
1999,Dec,67.8,66,3579098,3482815,96283,2.7
2000,Jan,67.9,66.2,3587812,3494250,93562,2.6
2000,Feb,68,66.3,3594384,3503720,90664,2.5
2000,Mar,68,66.3,3597995,3509963,88032,2.4
2000,Apr,68.1,66.5,3598633,3512676,85957,2.4
2000,May,68,66.4,3597365,3513008,84357,2.3
2000,Jun,67.9,66.3,3595504,3512567,82937,2.3
2000,Jul,67.8,66.3,3595262,3513928,81334,2.3
2000,Aug,67.8,66.3,3598924,3519350,79574,2.2
2000,Sep,67.8,66.4,3606796,3528934,77862,2.2
2000,Oct,68,66.5,3618451,3541678,76773,2.1
2000,Nov,68.1,66.7,3632208,3554953,77255,2.1
2000,Dec,68.3,66.8,3645647,3565891,79756,2.2
2001,Jan,68.4,66.8,3656586,3572496,84090,2.3
2001,Feb,68.5,66.8,3663965,3574300,89665,2.4
2001,Mar,68.5,66.7,3667561,3571974,95587,2.6
2001,Apr,68.4,66.5,3667975,3566723,101252,2.8
2001,May,68.3,66.3,3667259,3560434,106825,2.9
2001,Jun,68.2,66.1,3667065,3554152,112913,3.1
2001,Jul,68.2,65.9,3668296,3548360,119936,3.3
2001,Aug,68.1,65.7,3669981,3542141,127840,3.5
2001,Sep,68.1,65.5,3672084,3535982,136102,3.7
2001,Oct,68,65.4,3674919,3531248,143671,3.9
2001,Nov,68,65.2,3678283,3528681,149602,4.1
2001,Dec,68,65.2,3683084,3529384,153700,4.2
2002,Jan,68.1,65.2,3689739,3533571,156168,4.2
2002,Feb,68.1,65.2,3697408,3540024,157384,4.3
2002,Mar,68.2,65.3,3705408,3547398,158010,4.3
2002,Apr,68.3,65.4,3714103,3555752,158351,4.3
2002,May,68.4,65.5,3723149,3564919,158230,4.2
2002,Jun,68.5,65.6,3731744,3574268,157476,4.2
2002,Jul,68.5,65.6,3738523,3582081,156442,4.2
2002,Aug,68.5,65.7,3743211,3587564,155647,4.2
2002,Sep,68.5,65.6,3745885,3590376,155509,4.2
2002,Oct,68.4,65.6,3746262,3590164,156098,4.2
2002,Nov,68.4,65.5,3745646,3588573,157073,4.2
2002,Dec,68.3,65.4,3744775,3587049,157726,4.2
2003,Jan,68.2,65.3,3744855,3586938,157917,4.2
2003,Feb,68.2,65.3,3746918,3589024,157894,4.2
2003,Mar,68.2,65.4,3750084,3592434,157650,4.2
2003,Apr,68.2,65.4,3752119,3594787,157332,4.2
2003,May,68.2,65.3,3751647,3594486,157161,4.2
2003,Jun,68.1,65.2,3749944,3593008,156936,4.2
2003,Jul,68,65.1,3748699,3592613,156086,4.2
2003,Aug,67.9,65.1,3749007,3594516,154491,4.1
2003,Sep,67.8,65,3751599,3599230,152369,4.1
2003,Oct,67.8,65.1,3756702,3606279,150423,4
2003,Nov,67.8,65.1,3763255,3614066,149189,4
2003,Dec,67.8,65.1,3769524,3620788,148736,3.9
2004,Jan,67.8,65.1,3773898,3625113,148785,3.9
2004,Feb,67.7,65,3776127,3627246,148881,3.9
2004,Mar,67.6,65,3777894,3628971,148923,3.9
2004,Apr,67.6,64.9,3780248,3631701,148547,3.9
2004,May,67.5,64.9,3783514,3636081,147433,3.9
2004,Jun,67.5,64.9,3787662,3641958,145704,3.8
2004,Jul,67.5,64.9,3792869,3649059,143810,3.8
2004,Aug,67.5,65,3798891,3656820,142071,3.7
2004,Sep,67.5,65,3804876,3664166,140710,3.7
2004,Oct,67.5,65,3810444,3670507,139937,3.7
2004,Nov,67.5,65,3816184,3676396,139788,3.7
2004,Dec,67.6,65.1,3823748,3683335,140413,3.7
2005,Jan,67.7,65.2,3833916,3692480,141436,3.7
2005,Feb,67.8,65.3,3846117,3703824,142293,3.7
2005,Mar,68,65.5,3859630,3717207,142423,3.7
2005,Apr,68.1,65.6,3874382,3732427,141955,3.7
2005,May,68.3,65.8,3889902,3748596,141306,3.6
2005,Jun,68.5,66,3904202,3763447,140755,3.6
2005,Jul,68.6,66.1,3915450,3774915,140535,3.6
2005,Aug,68.6,66.2,3922921,3782705,140216,3.6
2005,Sep,68.6,66.2,3927170,3787938,139232,3.5
2005,Oct,68.5,66.1,3929641,3792574,137067,3.5
2005,Nov,68.5,66.1,3931532,3797763,133769,3.4
2005,Dec,68.4,66.2,3933528,3803760,129768,3.3
2006,Jan,68.4,66.2,3936945,3811208,125737,3.2
2006,Feb,68.4,66.3,3942457,3819918,122539,3.1
2006,Mar,68.5,66.4,3949684,3828751,120933,3.1
2006,Apr,68.6,66.5,3957762,3836685,121077,3.1
2006,May,68.6,66.5,3965965,3843632,122333,3.1
2006,Jun,68.7,66.5,3973863,3849874,123989,3.1
2006,Jul,68.8,66.6,3981949,3856643,125306,3.1
2006,Aug,68.8,66.7,3990610,3864596,126014,3.2
2006,Sep,68.9,66.7,3999375,3873318,126057,3.2
2006,Oct,69,66.8,4007656,3882561,125095,3.1
2006,Nov,69,66.9,4014613,3891398,123215,3.1
2006,Dec,69,67,4019079,3898326,120753,3
2007,Jan,69,67,4020595,3902272,118323,2.9
2007,Feb,68.9,66.9,4020219,3903783,116436,2.9
2007,Mar,68.8,66.9,4018972,3903711,115261,2.9
2007,Apr,68.8,66.8,4018162,3903277,114885,2.9
2007,May,68.7,66.7,4019091,3903524,115567,2.9
2007,Jun,68.7,66.7,4022656,3905318,117338,2.9
2007,Jul,68.8,66.7,4028886,3908754,120132,3
2007,Aug,68.8,66.7,4037631,3913767,123864,3.1
2007,Sep,68.9,66.8,4048461,3920620,127841,3.2
2007,Oct,69.1,66.8,4060091,3928594,131497,3.2
2007,Nov,69.2,66.9,4071799,3937545,134254,3.3
2007,Dec,69.3,67,4083460,3947470,135990,3.3
2008,Jan,69.4,67.1,4094298,3957008,137290,3.4
2008,Feb,69.6,67.2,4104063,3965200,138863,3.4
2008,Mar,69.6,67.3,4113238,3971681,141557,3.4
2008,Apr,69.7,67.3,4121849,3976129,145720,3.5
2008,May,69.8,67.3,4129890,3978871,151019,3.7
2008,Jun,69.9,67.2,4137526,3980695,156831,3.8
2008,Jul,69.9,67.2,4144200,3981731,162469,3.9
2008,Aug,69.9,67.1,4149182,3981181,168001,4
2008,Sep,69.9,66.9,4152142,3977381,174761,4.2
2008,Oct,69.8,66.7,4153146,3968914,184232,4.4
2008,Nov,69.7,66.4,4151870,3954841,197029,4.7
2008,Dec,69.6,66,4148515,3935818,212697,5.1
2009,Jan,69.4,65.6,4143762,3913981,229781,5.5
2009,Feb,69.3,65.2,4138697,3892397,246300,6
2009,Mar,69.2,64.8,4134643,3874611,260032,6.3
2009,Apr,69,64.5,4131894,3862173,269721,6.5
2009,May,68.9,64.3,4128969,3853300,275669,6.7
2009,Jun,68.8,64.1,4124789,3845784,279005,6.8
2009,Jul,68.6,63.9,4118816,3837551,281265,6.8
2009,Aug,68.4,63.7,4111312,3827632,283680,6.9
2009,Sep,68.2,63.4,4103792,3816940,286852,7
2009,Oct,68,63.2,4097753,3806654,291099,7.1
2009,Nov,67.9,63,4095945,3799649,296296,7.2
2009,Dec,67.9,62.9,4100552,3798877,301675,7.4
2010,Jan,68,63,4111141,3805371,305770,7.4
2010,Feb,68.2,63.1,4124601,3817085,307516,7.5
2010,Mar,68.3,63.3,4137711,3830874,306837,7.4
2010,Apr,67.5,62.5,4148999,3844786,304213,7.3
2010,May,67.6,62.7,4157743,3857567,300176,7.2
2010,Jun,67.6,62.8,4163295,3867279,296016,7.1
2010,Jul,67.5,62.8,4166373,3873305,293068,7
2010,Aug,67.5,62.8,4168725,3877131,291594,7
2010,Sep,67.5,62.8,4171404,3880460,290944,7
2010,Oct,67.5,62.8,4175430,3885597,289833,6.9
2010,Nov,67.5,62.8,4180277,3892824,287453,6.9
2010,Dec,67.5,62.9,4184771,3900973,283798,6.8
2011,Jan,67.5,63,4188985,3909237,279748,6.7
2011,Feb,67.5,63,4192419,3916211,276208,6.6
2011,Mar,67.4,63,4194471,3920687,273784,6.5
2011,Apr,67.4,63,4195672,3922364,273308,6.5
2011,May,67.4,63,4197759,3922591,275168,6.6
2011,Jun,67.4,62.9,4202228,3923950,278278,6.6
2011,Jul,67.4,62.9,4209618,3928498,281120,6.7
2011,Aug,67.5,63,4218678,3936029,282649,6.7
2011,Sep,67.5,63,4227345,3945096,282249,6.7
2011,Oct,67.6,63.1,4233999,3954022,279977,6.6
2011,Nov,67.5,63.1,4236996,3960885,276111,6.5
2011,Dec,67.5,63.1,4235857,3964606,271251,6.4
2012,Jan,67.3,63.1,4231959,3965563,266396,6.3
2012,Feb,67.2,63,4227576,3964867,262709,6.2
2012,Mar,67.1,62.9,4223386,3962491,260895,6.2
2012,Apr,66.9,62.8,4219059,3958783,260276,6.2
2012,May,66.8,62.7,4215862,3955951,259911,6.2
2012,Jun,66.7,62.6,4214807,3955826,258981,6.1
2012,Jul,66.7,62.6,4216026,3959188,256838,6.1
2012,Aug,66.7,62.7,4219676,3965800,253876,6
2012,Sep,66.7,62.8,4225316,3974214,251102,5.9
2012,Oct,66.7,62.8,4230738,3981872,248866,5.9
2012,Nov,66.7,62.8,4234388,3986946,247442,5.8
2012,Dec,66.7,62.8,4235476,3988734,246742,5.8
2013,Jan,66.6,62.7,4233882,3987394,246488,5.8
2013,Feb,66.5,62.7,4231342,3985091,246251,5.8
2013,Mar,66.5,62.6,4230364,3984797,245567,5.8
2013,Apr,66.5,62.6,4232476,3988103,244373,5.8
2013,May,66.5,62.7,4236360,3993156,243204,5.7
2013,Jun,66.5,62.7,4240390,3997692,242698,5.7
2013,Jul,66.5,62.7,4243329,4000637,242692,5.7
2013,Aug,66.4,62.6,4243935,4001894,242041,5.7
2013,Sep,66.4,62.6,4242422,4002314,240108,5.7
2013,Oct,66.3,62.6,4240822,4003108,237714,5.6
2013,Nov,66.2,62.6,4240890,4005444,235446,5.6
2013,Dec,66.2,62.6,4242889,4009409,233480,5.5
2014,Jan,66.2,62.6,4243063,4011746,231317,5.5
2014,Feb,66.2,62.6,4246185,4016655,229530,5.4
2014,Mar,66.2,62.6,4248247,4020018,228229,5.4
2014,Apr,66.1,62.6,4248198,4020708,227490,5.4
2014,May,66,62.5,4246223,4019716,226507,5.3
2014,Jun,66,62.5,4243692,4018945,224747,5.3
2014,Jul,65.9,62.4,4241063,4018636,222427,5.2
2014,Aug,65.8,62.4,4239070,4019184,219886,5.2
2014,Sep,65.7,62.3,4237867,4020659,217208,5.1
2014,Oct,65.6,62.3,4236442,4022274,214168,5.1
2014,Nov,65.5,62.3,4233898,4023082,210816,5
2014,Dec,65.5,62.2,4231098,4023247,207851,4.9
2015,Jan,65.4,62.2,4228612,4023313,205299,4.9
2015,Feb,65.3,62.2,4226909,4023365,203544,4.8
2015,Mar,65.3,62.1,4225814,4024415,201399,4.8
2015,Apr,65.2,62.1,4224748,4026561,198187,4.7
2015,May,65.1,62.1,4222632,4028709,193923,4.6
2015,Jun,65,62.1,4218688,4029725,188963,4.5
2015,Jul,64.9,62.1,4213773,4029769,184004,4.4
2015,Aug,64.8,62,4209037,4029329,179708,4.3
2015,Sep,64.7,62,4205561,4029258,176303,4.2
2015,Oct,64.6,62,4205086,4031145,173941,4.1
2015,Nov,64.6,62,4208081,4035413,172668,4.1
2015,Dec,64.7,62,4212798,4040905,171893,4.1
2016,Jan,64.7,62.1,4217419,4046321,171098,4.1
2016,Feb,64.7,62.1,4221083,4050676,170407,4
2016,Mar,64.7,62.1,4223683,4053627,170056,4
2016,Apr,64.8,62.1,4226269,4055795,170474,4
2016,May,64.8,62.1,4230261,4058438,171823,4.1
2016,Jun,64.8,62.2,4236047,4062274,173773,4.1
2016,Jul,64.9,62.2,4243217,4067551,175666,4.1
2016,Aug,65,62.3,4251076,4073950,177126,4.2
2016,Sep,65,62.3,4258801,4080800,178001,4.2
2016,Oct,65.1,62.4,4265400,4087526,177874,4.2
2016,Nov,65.1,62.4,4271133,4094578,176555,4.1
2016,Dec,65.1,62.5,4276971,4102515,174456,4.1
2017,Jan,65.2,62.6,4283427,4111349,172078,4
2017,Feb,65.3,62.7,4290337,4120793,169544,4
2017,Mar,65.3,62.8,4296893,4129781,167112,3.9
2017,Apr,65.4,62.9,4303237,4138362,164875,3.8
2017,May,65.4,63,4309486,4146856,162630,3.8
2017,Jun,65.5,63,4315181,4154719,160462,3.7
2017,Jul,65.5,63.1,4319979,4161450,158529,3.7
2017,Aug,65.5,63.1,4323055,4166527,156528,3.6
2017,Sep,65.5,63.1,4324186,4170033,154153,3.6
2017,Oct,65.4,63.1,4323829,4172499,151330,3.5
2017,Nov,65.4,63.1,4322440,4174224,148216,3.4
2017,Dec,65.3,63.1,4321090,4176250,144840,3.4
2018,Jan,65.3,63.2,4321285,4179688,141597,3.3
2018,Feb,65.3,63.2,4324074,4185221,138853,3.2
2018,Mar,65.4,63.3,4328875,4192335,136540,3.2
2018,Apr,65.4,63.4,4333258,4198820,134438,3.1
2018,May,65.4,63.4,4335747,4203196,132551,3.1
2018,Jun,65.4,63.4,4336930,4206240,130690,3
2018,Jul,65.4,63.4,4337899,4209196,128703,3
2018,Aug,65.4,63.5,4340536,4213317,127219,2.9
2018,Sep,65.4,63.5,4345973,4219278,126695,2.9
2018,Oct,65.5,63.6,4354026,4226855,127171,2.9
2018,Nov,65.6,63.7,4363519,4235273,128246,2.9
2018,Dec,65.7,63.8,4372388,4243038,129350,3
2019,Jan,65.8,63.8,4378779,4248896,129883,3
2019,Feb,65.8,63.9,4381973,4252554,129419,3
2019,Mar,65.8,63.9,4383549,4255394,128155,2.9
2019,Apr,65.8,63.9,4385945,4259615,126330,2.9
2019,May,65.9,64,4390760,4266437,124323,2.8
2019,Jun,66,64.1,4398723,4276136,122587,2.8
2019,Jul,66.1,64.3,4410824,4289574,121250,2.7
2019,Aug,66.3,64.5,4423894,4303811,120083,2.7
2019,Sep,66.4,64.6,4435867,4316769,119098,2.7
2019,Oct,66.5,64.7,4444122,4325663,118459,2.7
2019,Nov,66.5,64.7,4444649,4326215,118434,2.7
2019,Dec,66.4,64.6,4443312,4324694,118618,2.7
2020,Jan,66.5,64.8,4453928,4335613,118315,2.7
2020,Feb,66.6,64.9,4462573,4345324,117249,2.6
2020,Mar,66.3,64.1,4439350,4294056,145294,3.3
2020,Apr,64.4,57.2,4314050,3831939,482111,11.2
2020,May,64.2,58.4,4306310,3916764,389546,9
2020,Jun,64.3,59.1,4314260,3964636,349624,8.1
2020,Jul,64.4,59.3,4323137,3981495,341642,7.9
2020,Aug,64.8,60.8,4351449,4085038,266411,6.1
2020,Sep,63.7,59.8,4279495,4015630,263865,6.2
