Year,Period,labor force participation rate,employment-population ratio,labor force,employment,unemployment,unemployment rate
1976,Jan,65.1,62.4,175876,168592,7284,4.1
1976,Feb,64.8,62.1,175705,168416,7289,4.1
1976,Mar,64.6,61.9,175782,168487,7295,4.2
1976,Apr,64.7,62,176667,169387,7280,4.1
1976,May,64.9,62.3,177909,170664,7245,4.1
1976,Jun,65.2,62.6,179296,172109,7187,4
1976,Jul,65.4,62.9,180577,173470,7107,3.9
1976,Aug,65.6,63.1,181678,174649,7029,3.9
1976,Sep,65.7,63.2,182760,175766,6994,3.8
1976,Oct,65.9,63.4,183877,176869,7008,3.8
1976,Nov,66.1,63.6,185035,177991,7044,3.8
1976,Dec,66.3,63.8,186250,179158,7092,3.8
1977,Jan,66.5,64,187531,180397,7134,3.8
1977,Feb,66.5,64,188846,181712,7134,3.8
1977,Mar,66.7,64.2,190150,183087,7063,3.7
1977,Apr,66.9,64.5,191462,184548,6914,3.6
1977,May,67.2,64.8,192822,186101,6721,3.5
1977,Jun,67.4,65.2,194210,187678,6532,3.4
1977,Jul,67.7,65.5,195591,189199,6392,3.3
1977,Aug,67.9,65.7,196919,190620,6299,3.2
1977,Sep,67.9,65.7,198168,191935,6233,3.1
1977,Oct,68.1,65.9,199389,193189,6200,3.1
1977,Nov,68.2,66.1,200623,194454,6169,3.1
1977,Dec,68.2,66.1,201868,195768,6100,3
1978,Jan,68.4,66.4,203117,197111,6006,3
1978,Feb,68.6,66.6,204360,198430,5930,2.9
1978,Mar,68.5,66.6,205588,199677,5911,2.9
1978,Apr,68.7,66.7,206804,200829,5975,2.9
1978,May,68.9,66.8,207997,201878,6119,2.9
1978,Jun,68.8,66.7,209187,202879,6308,3
1978,Jul,69,66.8,210395,203892,6503,3.1
1978,Aug,69.2,67,211605,204938,6667,3.2
1978,Sep,69.1,66.9,212761,206026,6735,3.2
1978,Oct,69.2,67,213819,207161,6658,3.1
1978,Nov,69.3,67.2,214792,208322,6470,3
1978,Dec,69.4,67.4,215697,209487,6210,2.9
1979,Jan,69.2,67.3,216577,210655,5922,2.7
1979,Feb,69.3,67.5,217522,211849,5673,2.6
1979,Mar,69.4,67.6,218574,213058,5516,2.5
1979,Apr,69.5,67.8,219747,214259,5488,2.5
1979,May,69.5,67.8,221056,215461,5595,2.5
1979,Jun,69.7,67.9,222440,216643,5797,2.6
1979,Jul,69.9,68.1,223824,217790,6034,2.7
1979,Aug,70.1,68.2,225168,218896,6272,2.8
1979,Sep,70.1,68.1,226445,219920,6525,2.9
1979,Oct,70.3,68.2,227633,220822,6811,3
1979,Nov,70.2,68,228710,221609,7101,3.1
1979,Dec,70.2,68,229690,222323,7367,3.2
1980,Jan,70.1,67.8,230599,222990,7609,3.3
1980,Feb,70.1,67.8,231428,223601,7827,3.4
1980,Mar,70.2,67.7,232206,224164,8042,3.5
1980,Apr,70,67.5,232968,224707,8261,3.5
1980,May,70,67.4,233776,225272,8504,3.6
1980,Jun,70.1,67.4,234740,225919,8821,3.8
1980,Jul,70.2,67.5,235896,226677,9219,3.9
1980,Aug,70.4,67.5,237211,227566,9645,4.1
1980,Sep,70.6,67.6,238627,228604,10023,4.2
1980,Oct,70.8,67.8,240067,229753,10314,4.3
1980,Nov,71,67.9,241486,230964,10522,4.4
1980,Dec,71,67.9,242839,232208,10631,4.4
1981,Jan,71.2,68.1,244127,233499,10628,4.4
1981,Feb,71.3,68.3,245400,234870,10530,4.3
1981,Mar,71.5,68.5,246698,236326,10372,4.2
1981,Apr,71.7,68.7,248013,237810,10203,4.1
1981,May,71.8,68.9,249260,239208,10052,4
1981,Jun,71.9,69.1,250361,240414,9947,4
1981,Jul,72,69.2,251298,241391,9907,3.9
1981,Aug,72,69.2,252053,242123,9930,3.9
1981,Sep,72,69.1,252638,242627,10011,4
1981,Oct,72.1,69.2,253051,242959,10092,4
1981,Nov,72,69.1,253329,243173,10156,4
1981,Dec,71.8,68.9,253617,243328,10289,4.1
1982,Jan,71.8,68.8,254007,243459,10548,4.2
1982,Feb,71.7,68.6,254530,243527,11003,4.3
1982,Mar,71.7,68.4,255207,243449,11758,4.6
1982,Apr,71.9,68.3,255965,243168,12797,5
1982,May,71.9,68,256717,242674,14043,5.5
1982,Jun,71.9,67.6,257393,242014,15379,6
1982,Jul,71.8,67.2,257924,241243,16681,6.5
1982,Aug,72,67,258366,240464,17902,6.9
1982,Sep,71.9,66.6,258834,239809,19025,7.4
1982,Oct,72.1,66.5,259486,239396,20090,7.7
1982,Nov,72.1,66.3,260422,239214,21208,8.1
1982,Dec,72.4,66.2,261460,239100,22360,8.6
1983,Jan,72.7,66.2,262367,238920,23447,8.9
1983,Feb,72.6,65.9,262896,238618,24278,9.2
1983,Mar,72.6,65.8,262796,238185,24611,9.4
1983,Apr,72.2,65.5,262080,237715,24365,9.3
1983,May,71.9,65.4,260953,237376,23577,9
1983,Jun,71.3,65.2,259677,237319,22358,8.6
1983,Jul,71,65.3,258571,237613,20958,8.1
1983,Aug,70.8,65.4,257843,238189,19654,7.6
1983,Sep,70.7,65.6,257467,238853,18614,7.2
1983,Oct,70.7,65.8,257263,239384,17879,6.9
1983,Nov,70.8,66,256972,239646,17326,6.7
1983,Dec,70.7,66,256491,239616,16875,6.6
1984,Jan,70.5,65.9,255841,239329,16512,6.5
1984,Feb,70.3,65.8,255121,238939,16182,6.3
1984,Mar,70.1,65.7,254524,238643,15881,6.2
1984,Apr,70,65.7,254131,238507,15624,6.1
1984,May,70.2,65.9,253960,238494,15466,6.1
1984,Jun,70.2,65.9,253998,238536,15462,6.1
1984,Jul,70.2,65.9,254139,238546,15593,6.1
1984,Aug,70.2,65.9,254211,238446,15765,6.2
1984,Sep,70.4,66,254092,238170,15922,6.3
1984,Oct,70.3,65.8,253751,237710,16041,6.3
1984,Nov,70.3,65.9,253187,237115,16072,6.3
1984,Dec,70.1,65.7,252519,236511,16008,6.3
1985,Jan,70,65.5,251841,235938,15903,6.3
1985,Feb,70,65.6,251280,235402,15878,6.3
1985,Mar,69.9,65.5,250992,234980,16012,6.4
1985,Apr,70.1,65.6,251067,234746,16321,6.5
1985,May,70.2,65.6,251441,234703,16738,6.7
1985,Jun,70.6,65.8,251946,234767,17179,6.8
1985,Jul,70.7,65.8,252384,234819,17565,7
1985,Aug,70.8,65.8,252638,234763,17875,7.1
1985,Sep,70.6,65.5,252690,234559,18131,7.2
1985,Oct,70.5,65.4,252558,234203,18355,7.3
1985,Nov,70.5,65.3,252414,233743,18671,7.4
1985,Dec,70.5,65.1,252388,233228,19160,7.6
1986,Jan,70.3,64.8,252531,232733,19798,7.8
1986,Feb,70.4,64.7,252845,232288,20557,8.1
1986,Mar,70.5,64.6,253139,231809,21330,8.4
1986,Apr,70.5,64.4,253220,231233,21987,8.7
1986,May,70.3,64,252949,230483,22466,8.9
1986,Jun,70.1,63.8,252277,229511,22766,9
1986,Jul,69.8,63.4,251286,228366,22920,9.1
1986,Aug,69.7,63.3,250139,227149,22990,9.2
1986,Sep,69.6,63.1,249011,225974,23037,9.3
1986,Oct,69.5,63,248066,224940,23126,9.3
1986,Nov,69.5,62.9,247277,224065,23212,9.4
1986,Dec,69.4,62.9,246539,223362,23177,9.4
1987,Jan,69.4,62.9,245755,222807,22948,9.3
1987,Feb,69.3,63,244777,222315,22462,9.2
1987,Mar,69.2,63,243558,221803,21755,8.9
1987,Apr,69,63,242214,221280,20934,8.6
1987,May,68.8,63.1,240930,220841,20089,8.3
1987,Jun,68.7,63.2,239858,220558,19300,8
1987,Jul,68.7,63.3,239053,220438,18615,7.8
1987,Aug,68.5,63.4,238505,220459,18046,7.6
1987,Sep,68.4,63.4,238165,220613,17552,7.4
1987,Oct,68.6,63.7,237956,220866,17090,7.2
1987,Nov,68.5,63.7,237826,221176,16650,7
1987,Dec,68.5,63.8,237732,221473,16259,6.8
1988,Jan,68.5,63.9,237640,221728,15912,6.7
1988,Feb,68.7,64.2,237575,221973,15602,6.6
1988,Mar,68.7,64.2,237599,222250,15349,6.5
1988,Apr,68.7,64.3,237707,222536,15171,6.4
1988,May,68.7,64.4,237837,222753,15084,6.3
1988,Jun,69,64.6,237969,222881,15088,6.3
1988,Jul,69,64.6,238087,222924,15163,6.4
1988,Aug,69,64.6,238159,222904,15255,6.4
1988,Sep,69,64.6,238169,222842,15327,6.4
1988,Oct,69,64.6,238131,222776,15355,6.4
1988,Nov,69,64.6,238072,222761,15311,6.4
1988,Dec,69,64.6,238007,222816,15191,6.4
1989,Jan,69,64.6,237957,222920,15037,6.3
1989,Feb,69.2,64.8,237920,223021,14899,6.3
1989,Mar,69.1,64.8,237866,223058,14808,6.2
1989,Apr,69.1,64.8,237777,222998,14779,6.2
1989,May,69.1,64.8,237701,222908,14793,6.2
1989,Jun,69.1,64.8,237653,222843,14810,6.2
1989,Jul,69.1,64.8,237654,222853,14801,6.2
1989,Aug,69.1,64.8,237692,222974,14718,6.2
1989,Sep,69.1,64.9,237705,223185,14520,6.1
1989,Oct,69.1,65,237645,223438,14207,6
1989,Nov,69,65,237515,223673,13842,5.8
1989,Dec,69.2,65.3,237327,223842,13485,5.7
1990,Jan,72.1,68.1,237095,223927,13168,5.6
1990,Feb,72,68.1,236832,223934,12898,5.4
1990,Mar,71.9,68.1,236566,223892,12674,5.4
1990,Apr,71.8,68,236319,223815,12504,5.3
1990,May,71.7,68,236085,223678,12407,5.3
1990,Jun,71.7,67.9,235868,223491,12377,5.2
1990,Jul,71.6,67.8,235681,223300,12381,5.3
1990,Aug,71.6,67.8,235547,223135,12412,5.3
1990,Sep,71.3,67.5,235489,223028,12461,5.3
1990,Oct,71.3,67.5,235468,222992,12476,5.3
1990,Nov,71.3,67.5,235429,223010,12419,5.3
1990,Dec,71.1,67.3,235361,223065,12296,5.2
1991,Jan,71,67.4,235286,223142,12144,5.2
1991,Feb,71,67.4,235246,223229,12017,5.1
1991,Mar,70.8,67.2,235268,223322,11946,5.1
1991,Apr,70.8,67.2,235345,223411,11934,5.1
1991,May,70.8,67.2,235463,223497,11966,5.1
1991,Jun,70.7,67.1,235585,223551,12034,5.1
1991,Jul,70.7,67,235673,223532,12141,5.2
1991,Aug,70.5,66.8,235745,223443,12302,5.2
1991,Sep,70.5,66.8,235846,223322,12524,5.3
1991,Oct,70.4,66.5,236024,223222,12802,5.4
1991,Nov,70.4,66.5,236286,223196,13090,5.5
1991,Dec,70.3,66.4,236620,223295,13325,5.6
1992,Jan,70.4,66.4,237022,223529,13493,5.7
1992,Feb,70.3,66.3,237465,223859,13606,5.7
1992,Mar,70.5,66.4,237906,224242,13664,5.7
1992,Apr,70.4,66.3,238310,224632,13678,5.7
1992,May,70.5,66.4,238648,224990,13658,5.7
1992,Jun,70.3,66.3,238937,225333,13604,5.7
1992,Jul,70.4,66.4,239202,225694,13508,5.6
1992,Aug,70.3,66.4,239421,226067,13354,5.6
1992,Sep,70.3,66.5,239574,226428,13146,5.5
1992,Oct,70.1,66.3,239677,226737,12940,5.4
1992,Nov,70.2,66.4,239772,226975,12797,5.3
1992,Dec,70,66.3,239877,227135,12742,5.3
1993,Jan,70,66.3,239999,227251,12748,5.3
1993,Feb,69.9,66.1,240199,227415,12784,5.3
1993,Mar,70,66.2,240544,227691,12853,5.3
1993,Apr,69.9,66.1,241045,228117,12928,5.4
1993,May,70.1,66.3,241681,228697,12984,5.4
1993,Jun,70.1,66.3,242386,229366,13020,5.4
1993,Jul,70.3,66.5,243097,230057,13040,5.4
1993,Aug,70.3,66.5,243796,230740,13056,5.4
1993,Sep,70.3,66.5,244489,231407,13082,5.4
1993,Oct,70.5,66.7,245187,232069,13118,5.4
1993,Nov,70.5,66.7,245901,232740,13161,5.4
1993,Dec,70.7,66.9,246640,233435,13205,5.4
1994,Jan,70.7,66.9,247386,234157,13229,5.3
1994,Feb,70.9,67.1,248091,234883,13208,5.3
1994,Mar,70.8,67.1,248744,235624,13120,5.3
1994,Apr,71,67.3,249363,236398,12965,5.2
1994,May,71,67.4,249934,237173,12761,5.1
1994,Jun,70.9,67.4,250466,237942,12524,5
1994,Jul,71.1,67.6,250985,238704,12281,4.9
1994,Aug,71,67.6,251504,239444,12060,4.8
1994,Sep,71.2,67.8,252046,240146,11900,4.7
1994,Oct,71.1,67.8,252614,240808,11806,4.7
1994,Nov,71.3,68,253198,241430,11768,4.6
1994,Dec,71.4,68.1,253755,241961,11794,4.6
1995,Jan,71.4,68,254250,242369,11881,4.7
1995,Feb,71.5,68.1,254644,242652,11992,4.7
1995,Mar,71.3,67.9,254870,242782,12088,4.7
1995,Apr,71.3,67.9,254949,242788,12161,4.8
1995,May,71.2,67.7,255002,242788,12214,4.8
1995,Jun,71.2,67.8,255110,242846,12264,4.8
1995,Jul,71.2,67.8,255290,242968,12322,4.8
1995,Aug,71.1,67.6,255532,243155,12377,4.8
1995,Sep,71.1,67.7,255770,243380,12390,4.8
1995,Oct,71,67.6,255958,243598,12360,4.8
1995,Nov,71,67.6,256104,243771,12333,4.8
1995,Dec,71.1,67.6,256227,243901,12326,4.8
1996,Jan,70.9,67.5,256324,243989,12335,4.8
1996,Feb,70.9,67.5,256387,244008,12379,4.8
1996,Mar,70.9,67.5,256419,243960,12459,4.9
1996,Apr,70.9,67.4,256387,243835,12552,4.9
1996,May,70.7,67.2,256259,243627,12632,4.9
1996,Jun,70.6,67.1,256074,243394,12680,5
1996,Jul,70.4,66.9,255870,243182,12688,5
1996,Aug,70.3,66.8,255675,242983,12692,5
1996,Sep,70.2,66.7,255497,242773,12724,5
1996,Oct,70.2,66.7,255299,242525,12774,5
1996,Nov,69.9,66.4,255038,242228,12810,5
1996,Dec,69.8,66.3,254711,241890,12821,5
1997,Jan,69.7,66.2,254349,241542,12807,5
1997,Feb,69.6,66.1,254010,241255,12755,5
1997,Mar,69.6,66.1,253773,241117,12656,5
1997,Apr,69.5,66.1,253654,241142,12512,4.9
1997,May,69.5,66.1,253620,241284,12336,4.9
1997,Jun,69.3,66,253605,241465,12140,4.8
1997,Jul,69.3,66,253588,241640,11948,4.7
1997,Aug,69.3,66.1,253586,241807,11779,4.6
1997,Sep,69.3,66.1,253626,241985,11641,4.6
1997,Oct,69.3,66.2,253753,242191,11562,4.6
1997,Nov,69.4,66.2,253975,242431,11544,4.5
1997,Dec,69.5,66.3,254313,242745,11568,4.5
1998,Jan,69.6,66.4,254789,243159,11630,4.6
1998,Feb,69.8,66.6,255363,243649,11714,4.6
1998,Mar,69.9,66.7,255959,244147,11812,4.6
1998,Apr,70.1,66.8,256537,244620,11917,4.6
1998,May,70.2,66.9,257077,245053,12024,4.7
1998,Jun,70.1,66.8,257571,245442,12129,4.7
1998,Jul,70.3,66.9,258004,245792,12212,4.7
1998,Aug,70.4,67,258380,246117,12263,4.7
1998,Sep,70.5,67.1,258740,246436,12304,4.8
1998,Oct,70.6,67.2,259127,246781,12346,4.8
1998,Nov,70.5,67.1,259564,247176,12388,4.8
1998,Dec,70.6,67.2,260027,247589,12438,4.8
1999,Jan,70.7,67.3,260488,247994,12494,4.8
1999,Feb,70.8,67.4,260948,248407,12541,4.8
1999,Mar,70.8,67.4,261398,248831,12567,4.8
1999,Apr,70.9,67.5,261827,249271,12556,4.8
1999,May,71,67.6,262246,249743,12503,4.8
1999,Jun,71.1,67.7,262653,250247,12406,4.7
1999,Jul,71.2,67.9,263042,250771,12271,4.7
1999,Aug,71.1,67.8,263411,251311,12100,4.6
1999,Sep,71.2,68,263755,251866,11889,4.5
1999,Oct,71.1,67.9,264081,252439,11642,4.4
1999,Nov,71.2,68.1,264400,253038,11362,4.3
1999,Dec,71.2,68.3,264719,253660,11059,4.2
2000,Jan,71.1,68.2,265024,254277,10747,4.1
2000,Feb,71.2,68.4,265306,254841,10465,3.9
2000,Mar,71.3,68.5,265592,255335,10257,3.9
2000,Apr,71.4,68.7,265906,255749,10157,3.8
2000,May,71.5,68.8,266236,256080,10156,3.8
2000,Jun,71.6,68.8,266591,256356,10235,3.8
2000,Jul,71.6,68.9,266974,256616,10358,3.9
2000,Aug,71.7,68.9,267361,256894,10467,3.9
2000,Sep,71.8,68.9,267730,257213,10517,3.9
2000,Oct,71.8,69,268053,257561,10492,3.9
2000,Nov,71.9,69.1,268322,257910,10412,3.9
2000,Dec,71.9,69.1,268534,258231,10303,3.8
2001,Jan,71.9,69.2,268719,258518,10201,3.8
2001,Feb,71.9,69.2,268904,258760,10144,3.8
2001,Mar,71.9,69.2,269102,258959,10143,3.8
2001,Apr,72,69.2,269317,259125,10192,3.8
2001,May,72,69.2,269527,259254,10273,3.8
2001,Jun,72,69.2,269685,259339,10346,3.8
2001,Jul,72,69.2,269767,259389,10378,3.8
2001,Aug,71.9,69.1,269750,259382,10368,3.8
2001,Sep,71.8,69,269616,259295,10321,3.8
2001,Oct,71.6,68.9,269399,259138,10261,3.8
2001,Nov,71.5,68.8,269170,258929,10241,3.8
2001,Dec,71.4,68.6,269005,258703,10302,3.8
2002,Jan,71.3,68.5,268926,258486,10440,3.9
2002,Feb,71.2,68.4,268916,258300,10616,3.9
2002,Mar,71.1,68.3,268927,258160,10767,4
2002,Apr,71.1,68.2,268935,258089,10846,4
2002,May,71,68.1,268953,258119,10834,4
2002,Jun,70.9,68.1,269001,258240,10761,4
2002,Jul,70.9,68.1,269117,258426,10691,4
2002,Aug,70.9,68.1,269362,258670,10692,4
2002,Sep,71,68.1,269786,258965,10821,4
2002,Oct,71,68.1,270353,259278,11075,4.1
2002,Nov,71.2,68.2,270985,259585,11400,4.2
2002,Dec,71.3,68.2,271599,259876,11723,4.3
2003,Jan,71.4,68.2,272143,260160,11983,4.4
2003,Feb,71.5,68.3,272584,260454,12130,4.5
2003,Mar,71.5,68.3,272923,260769,12154,4.5
2003,Apr,71.6,68.4,273183,261110,12073,4.4
2003,May,71.6,68.4,273393,261481,11912,4.4
2003,Jun,71.6,68.5,273596,261886,11710,4.3
2003,Jul,71.6,68.6,273801,262292,11509,4.2
2003,Aug,71.6,68.6,274004,262656,11348,4.1
2003,Sep,71.5,68.6,274194,262950,11244,4.1
2003,Oct,71.5,68.6,274366,263168,11198,4.1
2003,Nov,71.5,68.6,274515,263340,11175,4.1
2003,Dec,71.5,68.6,274618,263491,11127,4.1
2004,Jan,71.4,68.6,274667,263639,11028,4
2004,Feb,71.4,68.6,274680,263807,10873,4
2004,Mar,71.3,68.6,274692,264013,10679,3.9
2004,Apr,71.3,68.6,274718,264225,10493,3.8
2004,May,71.2,68.5,274754,264384,10370,3.8
2004,Jun,71.2,68.5,274798,264467,10331,3.8
2004,Jul,71.1,68.4,274849,264495,10354,3.8
2004,Aug,71.1,68.4,274893,264497,10396,3.8
2004,Sep,71,68.3,274906,264501,10405,3.8
2004,Oct,71,68.3,274873,264534,10339,3.8
2004,Nov,70.9,68.3,274804,264610,10194,3.7
2004,Dec,70.8,68.3,274748,264741,10007,3.6
2005,Jan,70.8,68.3,274759,264927,9832,3.6
2005,Feb,70.8,68.3,274861,265143,9718,3.5
2005,Mar,70.8,68.3,275070,265378,9692,3.5
2005,Apr,70.8,68.3,275393,265649,9744,3.5
2005,May,70.9,68.4,275826,265979,9847,3.6
2005,Jun,71,68.4,276312,266351,9961,3.6
2005,Jul,71,68.4,276797,266732,10065,3.6
2005,Aug,71,68.4,277242,267111,10131,3.7
2005,Sep,71,68.5,277625,267494,10131,3.6
2005,Oct,71,68.4,277957,267897,10060,3.6
2005,Nov,71,68.4,278248,268336,9912,3.6
2005,Dec,70.9,68.5,278517,268825,9692,3.5
2006,Jan,70.9,68.5,278812,269389,9423,3.4
2006,Feb,70.9,68.6,279172,270022,9150,3.3
2006,Mar,71,68.7,279595,270671,8924,3.2
2006,Apr,71,68.8,280073,271282,8791,3.1
2006,May,71,68.8,280579,271811,8768,3.1
2006,Jun,71.1,68.8,281082,272239,8843,3.1
2006,Jul,71.1,68.8,281579,272606,8973,3.2
2006,Aug,71.1,68.8,282053,272971,9082,3.2
2006,Sep,71.1,68.8,282486,273376,9110,3.2
2006,Oct,71.1,68.8,282876,273867,9009,3.2
2006,Nov,71,68.8,283227,274449,8778,3.1
2006,Dec,71,68.9,283546,275082,8464,3
2007,Jan,71,68.9,283850,275706,8144,2.9
2007,Feb,70.9,68.9,284191,276280,7911,2.8
2007,Mar,70.9,69,284624,276805,7819,2.7
2007,Apr,71,69,285161,277287,7874,2.8
2007,May,71,69,285769,277734,8035,2.8
2007,Jun,71,69,286416,278176,8240,2.9
2007,Jul,71.1,69,287021,278627,8394,2.9
2007,Aug,71.1,69,287545,279098,8447,2.9
2007,Sep,71.1,69,288046,279630,8416,2.9
2007,Oct,71.1,69.1,288577,280229,8348,2.9
2007,Nov,71.1,69.1,289147,280868,8279,2.9
2007,Dec,71.2,69.2,289716,281500,8216,2.8
2008,Jan,71.2,69.2,290221,282065,8156,2.8
2008,Feb,71.2,69.2,290648,282544,8104,2.8
2008,Mar,71.2,69.2,291041,282960,8081,2.8
2008,Apr,71.2,69.2,291462,283349,8113,2.8
2008,May,71.2,69.2,291983,283769,8214,2.8
2008,Jun,71.3,69.3,292645,284250,8395,2.9
2008,Jul,71.4,69.3,293426,284773,8653,2.9
2008,Aug,71.5,69.3,294248,285272,8976,3.1
2008,Sep,71.5,69.3,294970,285626,9344,3.2
2008,Oct,71.5,69.2,295534,285732,9802,3.3
2008,Nov,71.5,69,296048,285541,10507,3.5
2008,Dec,71.6,68.8,296679,285078,11601,3.9
2009,Jan,71.7,68.5,297510,284410,13100,4.4
2009,Feb,71.8,68.2,298486,283611,14875,5
2009,Mar,71.9,67.9,299452,282766,16686,5.6
2009,Apr,72,67.6,300242,281983,18259,6.1
2009,May,72,67.4,300710,281311,19399,6.5
2009,Jun,71.9,67.1,300799,280759,20040,6.7
2009,Jul,71.8,66.9,300635,280326,20309,6.8
2009,Aug,71.7,66.8,300431,279999,20432,6.8
2009,Sep,71.6,66.7,300376,279777,20599,6.9
2009,Oct,71.6,66.6,300557,279657,20900,7
2009,Nov,71.6,66.6,300913,279665,21248,7.1
2009,Dec,71.7,66.6,301339,279841,21498,7.1
2010,Jan,71.7,66.6,301774,280222,21552,7.1
2010,Feb,71.8,66.7,302123,280793,21330,7.1
2010,Mar,71.8,66.8,302337,281479,20858,6.9
2010,Apr,69.8,65.2,302446,282195,20251,6.7
2010,May,69.8,65.3,302531,282900,19631,6.5
2010,Jun,69.8,65.4,302704,283583,19121,6.3
2010,Jul,69.8,65.5,303001,284227,18774,6.2
2010,Aug,69.9,65.6,303421,284841,18580,6.1
2010,Sep,70,65.7,303969,285423,18546,6.1
2010,Oct,70.1,65.8,304600,285972,18628,6.1
2010,Nov,70.2,65.9,305218,286461,18757,6.1
2010,Dec,70.2,65.9,305701,286854,18847,6.2
2011,Jan,70.3,66,305969,287153,18816,6.1
2011,Feb,70.3,66,306064,287421,18643,6.1
2011,Mar,70.2,66,306066,287721,18345,6
2011,Apr,70.2,66.1,306051,288070,17981,5.9
2011,May,70.2,66.2,306102,288452,17650,5.8
2011,Jun,70.2,66.2,306270,288849,17421,5.7
2011,Jul,70.2,66.3,306582,289259,17323,5.7
2011,Aug,70.2,66.3,307001,289658,17343,5.6
2011,Sep,70.2,66.2,307425,290022,17403,5.7
2011,Oct,70.2,66.2,307757,290332,17425,5.7
2011,Nov,70.1,66.2,307944,290592,17352,5.6
2011,Dec,70,66.1,307983,290823,17160,5.6
2012,Jan,69.9,66.1,307909,291027,16882,5.5
2012,Feb,69.8,66,307765,291172,16593,5.4
2012,Mar,69.6,65.9,307605,291232,16373,5.3
2012,Apr,69.5,65.8,307476,291207,16269,5.3
2012,May,69.4,65.7,307387,291112,16275,5.3
2012,Jun,69.3,65.6,307332,290981,16351,5.3
2012,Jul,69.2,65.5,307263,290838,16425,5.3
2012,Aug,69.1,65.4,307166,290725,16441,5.4
2012,Sep,69,65.3,307068,290689,16379,5.3
2012,Oct,68.9,65.3,306980,290753,16227,5.3
2012,Nov,68.8,65.2,306920,290901,16019,5.2
2012,Dec,68.8,65.2,306883,291091,15792,5.1
2013,Jan,68.7,65.2,306849,291304,15545,5.1
2013,Feb,68.6,65.2,306804,291528,15276,5
2013,Mar,68.6,65.2,306746,291757,14989,4.9
2013,Apr,68.5,65.2,306679,291974,14705,4.8
2013,May,68.4,65.2,306617,292152,14465,4.7
2013,Jun,68.4,65.2,306561,292274,14287,4.7
2013,Jul,68.3,65.1,306532,292348,14184,4.6
2013,Aug,68.3,65.1,306522,292385,14137,4.6
2013,Sep,68.3,65.1,306498,292395,14103,4.6
2013,Oct,68.3,65.1,306442,292400,14042,4.6
2013,Nov,68.2,65.1,306338,292432,13906,4.5
2013,Dec,68.2,65.2,306198,292523,13675,4.5
2014,Jan,68.1,65.1,305825,292432,13393,4.4
2014,Feb,68.1,65.2,305785,292662,13123,4.3
2014,Mar,68.1,65.3,305801,292916,12885,4.2
2014,Apr,68.1,65.3,305880,293160,12720,4.2
2014,May,68.2,65.4,306008,293379,12629,4.1
2014,Jun,68.2,65.4,306172,293549,12623,4.1
2014,Jul,68.2,65.4,306316,293648,12668,4.1
2014,Aug,68.2,65.4,306355,293681,12674,4.1
2014,Sep,68.1,65.3,306253,293668,12585,4.1
2014,Oct,68.1,65.3,306036,293633,12403,4.1
2014,Nov,68,65.3,305775,293590,12185,4
2014,Dec,67.9,65.2,305527,293518,12009,3.9
2015,Jan,67.8,65.1,305125,293147,11978,3.9
2015,Feb,67.7,65.1,304974,292866,12108,4
2015,Mar,67.7,65,304861,292482,12379,4.1
2015,Apr,67.7,64.8,304751,292036,12715,4.2
2015,May,67.6,64.7,304602,291577,13025,4.3
2015,Jun,67.5,64.6,304380,291150,13230,4.3
2015,Jul,67.4,64.5,304080,290778,13302,4.4
2015,Aug,67.4,64.4,303764,290436,13328,4.4
2015,Sep,67.3,64.3,303488,290074,13414,4.4
2015,Oct,67.3,64.2,303291,289645,13646,4.5
2015,Nov,67.2,64.1,303212,289125,14087,4.6
2015,Dec,67.3,64,303261,288508,14753,4.9
2016,Jan,67.3,63.9,303381,287824,15557,5.1
2016,Feb,67.3,63.7,303454,287103,16351,5.4
2016,Mar,67.3,63.6,303335,286366,16969,5.6
2016,Apr,67.2,63.4,302924,285641,17283,5.7
2016,May,67.1,63.2,302195,284943,17252,5.7
2016,Jun,66.9,63.1,301187,284286,16901,5.6
2016,Jul,66.6,63,300061,283685,16376,5.5
2016,Aug,66.4,62.9,298981,283148,15833,5.3
2016,Sep,66.2,62.8,298032,282683,15349,5.2
2016,Oct,66.1,62.7,297247,282295,14952,5
2016,Nov,66,62.7,296564,281982,14582,4.9
2016,Dec,65.8,62.7,295893,281742,14151,4.8
2017,Jan,65.7,62.7,295208,281572,13636,4.6
2017,Feb,65.6,62.7,294529,281452,13077,4.4
2017,Mar,65.5,62.7,293902,281354,12548,4.3
2017,Apr,65.5,62.8,293398,281264,12134,4.1
2017,May,65.4,62.8,293071,281175,11896,4.1
2017,Jun,65.4,62.8,292919,281071,11848,4
2017,Jul,65.4,62.8,292842,280937,11905,4.1
2017,Aug,65.4,62.7,292734,280774,11960,4.1
2017,Sep,65.4,62.7,292566,280584,11982,4.1
2017,Oct,65.3,62.6,292320,280372,11948,4.1
2017,Nov,65.2,62.6,292024,280158,11866,4.1
2017,Dec,65.2,62.5,291730,279971,11759,4
2018,Jan,65.1,62.5,291480,279834,11646,4
2018,Feb,65.1,62.5,291319,279768,11551,4
2018,Mar,65.1,62.5,291252,279766,11486,3.9
2018,Apr,65.1,62.5,291237,279782,11455,3.9
2018,May,65.1,62.5,291244,279789,11455,3.9
2018,Jun,65.1,62.5,291278,279808,11470,3.9
2018,Jul,65.1,62.5,291346,279865,11481,3.9
2018,Aug,65.1,62.5,291434,279981,11453,3.9
2018,Sep,65,62.5,291506,280171,11335,3.9
2018,Oct,65,62.5,291554,280435,11119,3.8
2018,Nov,65,62.6,291572,280731,10841,3.7
2018,Dec,65,62.6,291555,281011,10544,3.6
2019,Jan,65,62.7,291512,281239,10273,3.5
2019,Feb,64.9,62.7,291491,281400,10091,3.5
2019,Mar,64.9,62.7,291572,281521,10051,3.4
2019,Apr,64.9,62.7,291796,281644,10152,3.5
2019,May,65,62.7,292132,281782,10350,3.5
2019,Jun,65,62.7,292490,281906,10584,3.6
2019,Jul,65.1,62.7,292785,281998,10787,3.7
2019,Aug,65.1,62.7,292901,281995,10906,3.7
2019,Sep,65,62.6,292889,281961,10928,3.7
2019,Oct,65,62.6,292785,281900,10885,3.7
2019,Nov,64.9,62.5,292684,281856,10828,3.7
2019,Dec,64.9,62.5,292662,281857,10805,3.7
2020,Jan,65,62.6,293281,282542,10739,3.7
2020,Feb,65.2,62.8,294176,283296,10880,3.7
2020,Mar,65.5,63,295500,284302,11198,3.8
2020,Apr,65.7,59.4,296644,268301,28343,9.6
2020,May,65.2,59.5,294481,268691,25790,8.8
2020,Jun,65.5,60.5,295786,273334,22452,7.6
2020,Jul,65.2,60.5,294527,273685,20842,7.1
2020,Aug,64.6,60.4,292304,273109,19195,6.6
2020,Sep,65.2,61.2,294960,276990,17970,6.1
